border_size=1
usage=map

Ha          , Ha          , Ha          , Ha          , Ha          , Ha          , Ha          , Ha          , Ha          , Ha          , Ha          , Ha          , Ha          , Ms          , Ha          , Ha          , Aa          , Aa          , Aa          , Ha          , Ha          , Ha          
Ha^Fpa      , Ha          , Ha          , Ha          , Ha          , Ha          , Ha          , Ha^Fpa      , Ha^Fpa      , Ha          , Ha          , Ha          , Ha          , Ha          , Aa          , Aa          , Aa          , Aa          , Ha          , Ha          , Ha          , Ha          
Ha^Fpa      , Ha          , Ha^Fpa      , Ha          , Ha          , Ha          , Ha          , Ha^Fpa      , Ha          , Ha          , Ha          , Ha          , Ha          , Ha          , Ha          , Aa          , Aa          , Ha          , Ha          , Ha          , Ha          , Ha          
Ha          , Ha          , Ha          , Ha          , Ha          , Ha          , Ha          , Ha          , Ha          , Ha          , Ha          , Ha          , Ha          , Ha          , Ha          , Coa         , Aa          , Ha          , Ha          , Ha          , Ha          , Ha          
Ha          , Ha          , Ha          , Ha^Fpa      , Ha          , Ha          , Aa          , Aa          , Aa          , Ha          , Ha          , Ha          , Aa          , Ha          , Aa          , Aa          , Aa          , Ha          , Ha          , Ha          , Ha          , Ha          
Aa          , Ha          , Aa          , Ha          , Aa          , Aa          , Rb          , Rb          , Rb          , Aa          , Aa          , Aa          , Aa          , Aa          , Rb          , Aa          , Ha          , Ha          , Ha          , Ha^Fpa      , Ha          , Ha          
Rb          , Aa          , Rb          , Aa          , Rb          , Rb          , Rb          , Rb          , Aa          , Rb          , Rb          , Rb          , Rb          , Rb          , Rb          , Aa          , Aa          , Ha          , Ha          , Ha^Fpa      , Ha          , Ha          
Aa          , Rb          , Aa          , Rb          , Aa          , 2 Aa        , Aa          , Aa          , Ha          , Aa          , Aa          , Aa          , Aa          , Aa          , Aa          , Rb          , Aa          , Ha          , Ha          , Ha          , Ha          , Ha          
Ha          , Aa          , Ha          , Aa          , Aa          , Ha          , Ha          , Ha          , Ha          , Ha          , Ha          , Ha          , Ha          , Aa          , Aa          , Rb          , Aa          , Ha          , Ha          , Ha          , Ha          , Ha          
Ms          , Ms          , Ha          , Ha          , Ha          , Ha          , Ha          , Ha          , Ha          , Ha          , Ha          , Ha          , Aa          , Aa          , Rb          , Rb          , Aa          , Aa          , Ha^Fpa      , Ha          , Ha          , Ha          
Ms          , Ms          , Ha          , Ha^Voa      , Ha          , Ha          , Ha          , Ha          , Ms          , Ha          , Ha          , Aa          , Aa          , Coa         , Aa          , Aa          , Ha          , Ha          , Ha          , Ha          , Ha          , Ha          
Ha          , Ha          , Ha          , Ha          , Ha          , Ha          , Ms          , Ms          , Ms          , Ha          , Ha          , Ha          , Aa          , Rb          , Aa          , Aa          , Ha          , Ha          , Ha^Voa      , Ha          , Ha          , Ha          
Ha          , Ha          , Ha          , Ha          , Ha          , Ha          , Ha          , Ms          , Ha          , Ha          , Ha          , Ha          , Aa          , Rb          , Aa          , Ha          , Ms          , Ha          , Ha          , Ha          , Ha          , Ha          
Ha          , Ha          , Ha          , Ha          , Ha          , Ha          , Ha          , Ha          , Ha          , Ha          , Ms          , Ha          , Aa          , Rb          , Aa          , Ha          , Ha          , Ha          , Ha          , Ha          , Ha          , Ha          
Ms          , Ms          , Ha          , Aa          , Ha          , Ha          , Ha          , Ha          , Ms          , Ms          , Ha          , Aa          , Rb          , Rb          , Ha^Fpa      , Ha          , Ha          , Ms          , Ha          , Ha          , Ha          , Ms          
Ha          , Ha          , Ha          , Ha          , Ms          , Ms          , Ms          , Ms          , Ms          , Ha          , Aa          , Aa          , Rb          , Ha^Fpa      , Ha^Fpa      , Ha^Fpa      , Ha          , Ms          , Ms          , Ha          , Ms          , Ms          
Ha          , Ha          , Ha          , Ms          , Ha          , Ms          , Ms          , Ms          , Ha          , Ha          , Aa          , Rb          , Aa          , Ha^Fpa      , Ha          , Ha          , Ha          , Ha          , Ha          , Ms          , Ms          , Ms          
Ha          , Ha          , Ha          , Ha          , Ha          , Ha          , Ha          , Ha          , Ha          , Aa          , Aa          , Rb          , Rb          , Aa          , Ha          , Ha          , Ha          , Ha          , Ha          , Ha          , Ha          , Ha          
Ha          , Ha          , Ha          , Ha          , Ha          , Ha          , Ha          , Ha          , Aa          , 1 Aa        , Rb          , Rb          , Aa          , Aa          , Ha          , Ha          , Ha          , Ha          , Ha^Voa      , Ha          , Ha          , Ha          
Ha          , Ha          , Ha          , Ha          , Ha          , Ha          , Aa          , Aa          , Rb          , Rb          , Rb          , Aa          , Aa          , Ha          , Ha          , Ha          , Ha          , Ha          , Ha          , Ha          , Ha          , Ha          
Ha          , Ha          , Ha          , Ha          , Ha          , Ha          , Aa          , Rb          , Aa          , Rb          , Aa          , Aa          , Ha          , Ha          , Ha          , Ha          , Ha          , Ha^Fpa      , Ha          , Ha          , Ha          , Ha          
Ha^Fpa      , Ha          , Ha          , Ha          , Ha          , Ha          , Aa          , Aa          , Aa          , Aa          , Ha          , Ha          , Ha          , Ha          , Ha          , Ha          , Ha          , Ha          , Ha          , Ha          , Ha          , Ha          
