border_size=1
usage=map

Ha          , Ha          , Ha          , Ha          , Ha          , Ha          , Ha          , Ha          , Ha          , Ha          , Ha          , Ms          , Ms          , Ms          , Ha          , Ha          , Aa          , Aa          , Aa          , Ha          , Ha          , Ha          
Ha^Fpa      , Ha          , Ha          , Ha          , Ha^Fpa      , Ha          , Ha^Fpa      , Ha^Fpa      , Ha^Fpa      , Ha          , Ha          , Ha          , Ha          , Ha          , Ha          , Ha          , Aa          , Aa          , Aa          , Ha          , Ha          , Ha          
Ha^Fpa      , Ha          , Ha^Fpa      , Ha          , Ha          , Ha^Fpa      , Ha          , Ha^Fpa      , Ha          , Ha          , Ha          , Ha          , Ha          , Ha          , Ha          , Ha          , Aa          , Aa          , Aa          , Ha          , Ha          , Ha          
Ha          , Ha          , Ha          , Ha          , Ha^Fpa      , Ha          , Ha          , Ha          , Ha          , Ha          , Cha         , Ha          , Ha          , Ha          , Aa          , Aa          , Rb          , Rb          , Aa          , Ha          , Ha          , Ha          
Ha          , Ha          , Ha          , Ha^Fpa      , Ha          , Ha          , Ha          , Ha          , Aa          , Aa          , Rb          , Aa          , Aa^Vha      , Aa          , Rb          , Rb          , Aa          , Aa          , Ha          , Ha          , Ha          , Ha          
Ha          , Ha          , Ha          , Ha          , Ha          , Ha          , Aa          , Aa          , Rb          , Rb          , Rb          , Rb          , Rb          , Rb          , Rb          , Aa          , Ha          , Ha          , Ha          , Ha^Fpa      , Ha          , Ha          
Ha          , Ha          , Ha          , Ha          , Ha          , Aa          , Rb          , Rb          , Aa          , Rb          , Aa          , Aa          , Aa          , Aa          , Aa          , Aa          , Ha          , Ha          , Ha          , Ha^Fpa      , Ha          , Ha          
Ha          , Ha          , Ha          , Ha          , Ha          , 2 Aa        , Aa          , Aa          , Ha          , Ha          , Aa^Fpa      , Aa          , Aa          , Ha          , Ha          , Ha          , Ha          , Ha          , Ha          , Ha          , Ha          , Ha          
Ha          , Ha          , Ha          , Ha          , Ha          , Aa          , Aa          , Aa          , Aa          , Ha          , Aa          , Rb          , Rb          , Aa          , Ha          , Ha          , Ha          , Ha          , Ha          , Ha          , Ha          , Ha          
Ms          , Ms          , Ha          , Ha          , Ha          , Aa^Fpa      , Aa          , Rb          , Aa          , Aa          , Aa          , Rb          , Ha          , Ha          , Ha          , Ha          , Ha          , Ha^Fpa      , Ha^Fpa      , Ha          , Ha          , Ha          
Ms          , Ms          , Ha          , Ha          , Ha          , Ha          , Aa          , Rb          , Aa          , Ha          , Ha          , Ha          , Ms          , Ha          , Ha          , Ha          , Ha          , Ha          , Ha          , Ha          , Ha          , Ha          
Ha          , Ha          , Ha          , Ha          , Ha          , Ha          , Aa          , Rb          , Rb          , Aa          , Ha          , Ha          , Ha          , Ha          , Ha          , Ha          , Ha          , Ha          , Ha          , Ha          , Ms          , Ha          
Ha          , Ha          , Ha          , Ha          , Ha          , Ha          , Aa          , Aa          , Rb          , Aa          , Ha          , Ha          , Ha          , Ha          , Ha          , Ha          , Ms          , Ha          , Ha          , Ms          , Ms          , Ha          
Ha          , Ha          , Ha          , Ha          , Ha          , Ha          , Cha         , Aa          , Aa          , Aa          , Ha          , Ha          , Ha          , Ha          , Ha          , Ha          , Ha          , Ha          , Ms          , Ms          , Ms          , Ms          
Ms          , Ms          , Ha          , Aa          , Ha          , Ha          , Aa          , Aa          , Rb          , Aa          , Ha          , Ha          , Ha          , Ha^Fpa      , Ha^Fpa      , Ha          , Ha          , Ms          , Ms          , Ms          , Ms          , Ms          
Ha          , Ha          , Ha          , Ha          , Ha^Fpa      , Ha          , Ha          , Aa          , Rb          , Aa          , Aa          , Ha          , Ha          , Ha^Fpa      , Ha^Fpa      , Ha^Fpa      , Ha          , Ms          , Ms          , Ms          , Ms          , Ms          
Ha          , Ha          , Ha          , Ha^Fpa      , Ha^Fpa      , Ha          , Ha          , Aa          , Rb          , Rb          , Aa          , Ha          , Ha          , Ha^Fpa      , Ha          , Ha          , Ha          , Ha          , Ha          , Ms          , Ms          , Ms          
Ha          , Ha          , Ha          , Ha          , Ha^Fpa      , Ha          , Ha          , Aa          , Rb          , Rb          , Aa          , Ha          , Ha          , Ha          , Ha          , Ha          , Ha          , Ha          , Ha          , Ha          , Ha          , Ha          
Ha          , Ha          , Ha          , Ha          , Ha          , Ha          , Ha          , Aa          , Aa          , 1 Rb        , Aa          , Ha          , Ha          , Ha          , Ha          , Ha          , Ha          , Ha          , Ha          , Ha          , Ha          , Ha          
Ha^Fpa      , Ha          , Ha          , Ha          , Ha          , Ha          , Ha          , Aa          , Aa          , Rb          , Aa^Vha      , Aa          , Aa          , Ha          , Ha          , Ha          , Ha          , Ha          , Ha          , Ha          , Ha          , Ha          
Ha^Fpa      , Ha^Fpa      , Ha          , Ha          , Ha          , Ha          , Ha          , Ha          , Ha          , Aa          , Aa          , Aa          , Aa          , Ha          , Ha          , Ha          , Ha^Fpa      , Ha^Fpa      , Ha          , Ha          , Ha          , Ha          
Ha^Fpa      , Ha^Fpa      , Ha          , Ha          , Ha^Fpa      , Ha          , Ha          , Ha          , Ha          , Aa          , Aa          , Aa          , Aa          , Ha          , Ha          , Ha^Fpa      , Ha^Fpa      , Ha^Fpa      , Ha          , Ha          , Ha          , Ha          
