border_size=1
usage=map

Aa          , Aa          , Aa          , Aa^Fpa      , Aa          , Aa^Fpa      , Aa^Fpa      , Aa^Fpa      , Aa          , Aa          , Aa          , Aa^Fpa      , Aa^Fpa      , Ha^Fpa      , Ha^Fpa      , Ha^Fpa      , Ha^Fpa      , Aa          , Aa          , Aa          , Aa          , Aa          
Rb          , Aa          , Aa          , Aa          , Aa          , Aa          , Aa          , Aa          , Aa          , Aa          , Aa          , Aa          , Aa          , Aa          , Aa          , Ha^Fpa      , Ha^Fpa      , Aa          , Aa          , Aa          , Aa          , Aa          
Rr          , Rb          , Aa          , Aa          , Aa          , Aa          , Ha          , Aa          , Aa          , Aa          , Aa          , Aa          , Aa          , Aa          , Aa          , Ha^Fpa      , Ha^Fpa      , Ha^Fpa      , Aa          , Aa          , Aa          , Aa          
Rr          , Rb          , Rb          , Aa          , Aa          , Aa          , Ha          , Ha          , Aa          , Aa          , Rb          , Aa^Vha      , Aa^Fpa      , Aa          , Aa          , Aa          , Aa          , Ha^Fpa      , Aa          , Aa          , Ai          , Ai          
Rb          , Rr          , Rr          , Rb          , Aa          , Aa          , Aa          , Ha          , Aa          , Rb          , Rb          , Rb          , Rb          , Aa^Fpa      , Aa          , Aa          , Aa          , Ha^Fpa      , Aa          , Ai          , Ai          , Ai          
Aa          , Rb          , Rr          , Rb          , Rb          , Aa          , Aa          , Aa          , Aa          , Aa          , Aa          , Rb          , Aa^Fpa      , Aa^Fpa      , Aa          , Aa          , Ha^Fpa      , Aa          , Ai          , Ai          , Ai          , Aa          
Aa          , Rb          , Rr          , Rr          , Rb          , Rb          , Rb          , Aa          , Aa          , Aa          , Aa          , Aa^Fpa      , Aa          , Aa^Fpa      , Aa          , Aa          , Aa          , Ai          , Ai          , Ai          , Aa          , Aa          
Aa          , Rb          , Rb          , Rr          , Rr          , 2 Rb        , Rb          , Rb          , Aa          , Aa          , Aa          , Aa          , Aa          , Aa          , Aa          , Aa          , Ai          , Ai          , Ai          , Aa          , Ha^Fpa      , Ha^Fpa      
Aa          , Aa          , Rb          , Rb          , Rb          , Rr          , Rr          , Rb          , Rb          , Aa          , Aa          , Aa          , Aa          , Aa          , Aa          , Aa          , Ai          , Ai          , Ai          , Ha^Fpa      , Ha^Fpa      , Ha^Fpa      
Aa          , Aa          , Aa          , Rb          , Rb          , Rb          , Rr          , Rb          , Rb          , Aa          , Aa          , Ha          , Aa          , Aa          , Aa          , Ai          , Ai          , Ai          , Ai          , Ha^Fpa      , Ha^Fpa      , Ha^Fpa      
Ha^Fpa      , Aa          , Aa          , Aa          , Rb          , Rb          , Rr          , Rb          , Rb          , Aa          , Aa          , Aa          , Aa          , Aa          , Aa          , Ai          , Ai          , Ai          , Ai          , Aa^Fpa      , Ha^Fpa      , Ha^Fpa      
Ha^Fpa      , Ha^Fpa      , Aa          , Aa          , Rb          , Rb          , Rr          , Rr          , Rb          , Aa^Vha      , Aa          , Aa          , Aa          , Aa          , Ai          , Ai          , Ai          , Ai          , Ai          , Ai          , Aa^Fpa      , Ha^Fpa      
Ha^Fpa      , Aa          , Aa          , Aa          , Aa          , Rb          , Rr          , Rr          , Ai          , Ai          , Ai          , Ai          , Ai          , Ai          , Ai          , Ai          , Aa          , Aa          , Aa          , Aa^Fpa      , Aa^Fpa      , Aa^Fpa      
Ha^Fpa      , Aa          , Aa          , Aa          , Aa          , Cha         , Ai          , Ai^Bw\      , Ai^Bw\      , Ai          , Cha         , Ai          , Aa          , Ai          , Aa          , Aa          , Aa          , Aa          , Aa          , Aa          , Aa^Fpa      , Aa^Fpa      
Ha^Fpa      , Aa          , Aa          , Aa          , Ai          , Ai          , Ai          , Ai          , Rr          , Rr          , Aa          , Aa          , Aa          , Aa          , Ha          , Ha^Fpa      , Ha^Fpa      , Aa          , Aa          , Aa          , Aa          , Aa^Fpa      
Aa          , Aa          , Ai          , Ai          , Ai          , Ai          , Rb          , Rb          , Rr          , Rb          , Rb          , Aa          , Aa          , Ha          , Ha          , Ha^Fpa      , Ha          , Aa          , Aa          , Aa          , Aa          , Aa^Fpa      
Aa          , Ai          , Ai          , Ai          , Aa          , Aa          , Rb          , Rr          , Rr          , Rb          , Rb          , Rb          , Rb          , Aa          , Aa          , Ha          , Aa          , Aa          , Aa^Fpa      , Aa          , Aa^Fpa      , Aa          
Ai          , Ai          , Aa          , Ai          , Aa          , Aa          , Aa          , Rb          , Rb          , Rr          , Rr          , Rb          , Rb          , Rb          , Aa          , Aa          , Aa          , Aa          , Aa          , Aa^Fpa      , Aa          , Aa          
Aa          , Aa          , Aa          , Aa          , Aa^Fpa      , Aa          , Aa          , Aa          , Aa          , 1 Rb        , Rb          , Rr          , Rb          , Rb          , Aa          , Aa          , Aa          , Aa          , Aa          , Aa          , Aa          , Aa          
Aa^Fpa      , Aa          , Aa          , Aa^Fpa      , Aa^Fpa      , Aa^Fpa      , Aa          , Aa          , Aa          , Aa          , Rb          , Rr          , Rb          , Rb          , Aa          , Aa          , Aa          , Aa^Fpa      , Aa^Fpa      , Aa^Fpa      , Aa          , Aa          
Aa^Fpa      , Aa          , Aa          , Aa^Fpa      , Aa          , Aa^Fpa      , Aa          , Aa          , Aa          , Aa          , Rb          , Rr          , Rb          , Rb          , Aa          , Aa          , Aa          , Aa          , Aa^Fpa      , Aa^Fpa      , Aa          , Aa          
Aa^Fpa      , Aa^Fpa      , Aa^Fpa      , Aa          , Aa          , Aa          , Aa          , Aa          , Aa          , Aa          , Rb          , Rr          , Rb          , Rb          , Aa          , Aa          , Aa          , Aa          , Aa^Fpa      , Aa^Fpa      , Aa^Fpa      , Aa          
