border_size=1
usage=map

Ha          , Ha          , Ha          , Ha          , Ha          , Aa          , Aa^Fpa      , Aa^Fpa      , Aa^Fpa      , Aa          , Aa          , Aa          , Aa          , Aa          , Aa          , Aa          , Aa          , Ha          , Ha          , Ha          , Ha          , Aa^Fpa      
Aa^Fpa      , Ha          , Aa          , Aa          , Aa          , Aa          , Aa          , Aa          , Aa          , Aa          , Aa          , Aa          , Aa          , Aa          , Aa          , Aa          , Aa          , Aa          , Aa          , Ha          , Aa          , Ha          
Aa^Fpa      , Aa          , Aa          , Ai          , Aa          , Aa          , Aa^Fpa      , Aa          , Aa          , Aa          , Aa^Fpa      , Aa^Fpa      , Aa          , Aa          , Aa          , Aa          , Aa          , Aa          , Aa          , Aa          , Aa          , Aa          
Aa^Fpa      , Aa          , Aa          , Ai          , Aa          , Aa          , Aa          , Aa          , Aa          , Aa          , Aa          , Aa^Fpa      , Aa          , Aa^Fpa      , Aa^Fpa      , Aa          , Aa          , Aa          , Aa          , Aa          , Aa          , Aa          
Aa          , Aa          , Aa          , Aa          , Aa          , Rb          , Rb          , Aa          , Ha          , Ha          , Ha          , Aa          , Aa          , Aa          , Aa          , Aa^Fpa      , Aa          , Aa          , Aa          , Aa          , Aa          , Ha          
Aa          , Aa          , Aa          , Aa^Fpa      , Aa          , Aa          , Rb          , Aa          , Aa          , Cha         , Aa          , Aa          , Ha          , Aa          , Aa          , Aa          , Aa          , Aa          , Aa          , Aa          , Aa          , Ha          
Aa          , Aa          , Aa          , Aa          , Rb          , Aa          , Rb          , Aa          , Aa          , Aa          , Aa          , Aa          , Aa          , Aa          , Aa          , Aa          , Ha          , Ha          , Aa          , Aa          , Aa          , Aa          
Aa          , Aa          , Aa          , Aa          , Aa          , Rb          , Rb          , Aa^Fpa      , Rb          , Aa          , Aa          , Aa          , Rb          , Aa          , Aa          , Aa          , Aa          , Ha          , Aa          , Aa          , Aa          , Aa          
Aa          , Aa          , Aa          , Aa^Fpa      , Aa          , 1 Aa        , Aa          , Rb          , Re          , Rb          , Rb          , Aa          , Aa^Fpa      , Rb          , Aa          , Aa          , Aa          , Aa          , Aa          , Aa          , Aa          , Aa          
Aa          , Aa          , Aa          , Aa          , Rb          , Aa          , Aa          , Rb          , Rb          , Re          , Re          , Re          , Rb          , Aa          , Aa          , Aa          , Aa          , Aa          , Aa          , Aa          , Aa          , Aa          
Aa          , Aa          , Aa          , Aa          , Rb          , Aa^Vha      , Ai          , Aa          , Aa^Fpa      , Rb          , Aa          , Rb          , Rb          , Rb          , Aa          , Aa          , Aa          , Aa          , Aa          , Aa          , Aa^Fpa      , Aa          
Ha          , Aa          , Aa          , Aa          , Aa          , Rb          , Ai          , Aa          , Aa          , Aa          , Aa          , Aa          , Rb          , Aa          , Aa          , Aa          , Aa          , Aa          , Aa          , Aa          , Aa          , Aa^Fpa      
Ha          , Aa^Fpa      , Aa          , Aa          , Aa          , Aa          , Aa          , Aa          , Ha          , Ha          , Aa          , Aa          , Rb          , Rb          , Aa          , Aa          , Aa          , Aa          , Aa^Vha      , Aa          , Aa          , Aa          
Ms          , Ha          , Ha          , Aa          , Aa          , Aa          , Aa          , Aa          , Ha^Fpa      , Aa^Fpa      , Aa          , Ai          , Aa          , Rb          , Aa          , Aa          , Aa          , Rb          , Rb          , Aa          , Aa          , Aa          
Ha          , Aa          , Aa          , Aa          , Aa          , Aa          , Aa          , Aa          , Aa          , Aa          , Aa          , Aa          , Rb          , Rb          , Aa          , Aa          , Aa          , Aa          , Aa          , Aa          , Aa          , Aa          
Ha          , Aa          , Aa          , Aa^Fpa      , Aa          , Rb          , Cha         , Aa          , Aa          , Aa^Fpa      , Aa          , Rb          , Rb          , Rb          , Rb          , Aa          , Aa          , Aa          , Aa          , Aa          , Aa          , Aa          
Aa          , Aa          , Aa          , Aa          , Rb          , Rb          , Aa          , Aa          , Aa          , Aa          , Aa          , Aa          , Rb          , 2 Aa        , Aa          , Rb          , Aa          , Aa          , Aa          , Aa          , Ha          , Aa          
Aa          , Aa          , Aa          , Aa          , Aa          , Rb          , Rb          , Aa          , Aa^Fpa      , Aa          , Rb          , Rb          , Aa          , Aa          , Rb          , Rb          , Aa          , Aa          , Aa^Fpa      , Ha          , Ha          , Ha          
Aa          , Aa          , Aa          , Aa^Fpa      , Aa          , Rb          , Rb          , Aa          , Aa          , Aa          , Aa          , Aa          , Aa          , Aa          , Rb          , Aa          , Aa          , Aa          , Aa          , Aa          , Aa          , Aa          
Aa          , Aa          , Aa          , Ha          , Ha          , Aa          , Aa          , Aa          , Aa^Fpa      , Aa          , Aa          , Aa          , Aa          , Rb          , Aa          , Rb          , Aa          , Aa          , Aa          , Aa          , Aa          , Aa          
Aa          , Aa          , Aa          , Aa          , Aa          , Aa          , Aa          , Aa          , Aa          , Aa          , Aa          , Aa          , Aa          , Aa          , Aa          , Aa          , Aa          , Aa          , Aa          , Aa          , Aa          , Aa          
Ha          , Ha          , Ha          , Ha          , Ha          , Ha          , Aa          , Aa^Fpa      , Aa          , Aa^Fpa      , Aa          , Aa          , Aa          , Aa          , Aa          , Aa          , Aa          , Aa          , Aa          , Aa          , Ha          , Ha          
