border_size=1
usage=map

Xu          , Xu          , Xu          , Xu          , Xu          , Xu          , Xu          , Xu          , Xu          , Xu          , Xu          , Xu          , Xu          , Xu          , Wog         , Wog         , Xu          , Xu          , Xu          , Uu^Ii       , Urb^Ii      , Urb^Ii      , Urb^Ii      , Urb^Ii      , Urb^Ii      , Uu^Ii       , Uu          , Xu          , Xu          , Xu          , Xu          , Xu          , Xu          , Xu          , Xu          , Xu          , Xu          , Xu          , Xu          , Uu          , Uu          , Xu          
Xu          , Xu          , Xu          , Xu          , Xu          , Xu          , Xu          , Xu          , Xu          , Xu          , Xu          , Xu          , Uu^Uf       , Uu^Uf       , Wog         , Wog         , Xu          , Xu          , Xu          , Uu^Ii       , Uu^Ii       , Urb^Ii      , Urb^Ii      , Urb^Ii      , Urb^Ii      , Uu^Ii       , Xu          , Xu          , Xu          , Xu          , Xu          , Xu          , Xu          , Xu          , Xu          , Xu          , Xu          , Xu          , Uu          , Uu          , Uu          , Xu          
Xu          , Xu          , Xu          , Xu          , Xu          , Xu          , Urb         , Xu          , Xu          , Xu          , Xu          , Xu          , Uu^Uf       , Uu^Uf       , Wog         , Wog         , Xu          , Xu          , Uu          , Uu          , Uu          , Uu          , Urb         , Urb         , Urb         , Uu          , Xu          , Xu          , Xu          , Xu          , Xu          , Xu          , Xu          , Xu          , Uu          , Xu          , Uu          , 2 Uh        , Uu          , Uu          , Xu          , Xu          
Xu          , Xu          , Xu          , Xu          , Xu          , Urb         , Urb         , Urb         , Xu          , Xu          , Xu          , Xu          , Uu^Uf       , Uu^Uf       , Wog         , Wog         , Xu          , Xu          , Xu          , Xu          , Xu          , Uu          , Uu          , Urb         , Urb         , Uu^Vud      , Xu          , Xu          , Xu          , Xu          , Xu          , Xu          , Xu          , Uu^Vu       , Rr          , Rr          , Rr          , Uu          , Uh          , Xu          , Xu          , Xu          
Xu          , Xu          , Xu          , Xu          , Xu          , Rr          , Rr          , Rr          , Xu          , Xu          , Xu          , Xu          , Xu          , Uu^Uf       , Wog         , Wog         , Xu          , Xu          , Xu          , Xu          , Xu          , Xu          , Uu^Vud      , Urb         , Urb         , Uu          , Xu          , Xu          , Xu          , Xu          , Xu          , Xu          , Uu          , Uu          , Rr          , Rr          , Rr          , Uu          , Xu          , Uh          , Xu          , Xu          
Xu          , Xu          , Xu          , Xu          , Xu          , Rr          , Xu          , Rr          , Rr          , Rr          , Rr          , Xu          , Xu          , Uu^Uf       , Wog         , Wog         , Xu          , Xu          , Xu          , Xu          , Xu          , Xu          , Xu          , Urb         , Urb         , Urb         , Urb         , Xu          , Xu          , Xu          , Uu          , Xu          , Uu          , Uu          , Chr         , Uu          , Uu          , Uu          , Xu          , Xu          , Xu          , Xu          
Xu          , Xu          , Xu          , Xu          , Xu          , Rr          , Xu          , Uu          , Xu          , Rr          , Rr          , Xu          , Xu          , Xu          , Wog         , Wog         , Uu^Uf       , Xu          , Xu          , Xu          , Xu          , Xu          , Xu          , Uu          , Uu          , Urb         , Uu          , Urb         , Uu          , Uu          , Xu          , Uu          , Xu          , Chr         , Khr         , Chr         , Xu          , Uu          , Xu          , Xu          , Xu          , Xu          
Xu          , Xu          , Xu          , Xu          , Xu          , Rr          , Uu          , Uu          , Xu          , Rr          , Cud         , Xu          , Xu          , Xu          , Wog         , Wog         , Wog         , Xu          , Xu          , Xu          , Xu          , Xu          , Xu          , Uu^Vu       , Xu          , Xu          , Xu          , Uu          , Uu          , Uu          , Xu          , Xu          , Xu          , Xu          , Xu          , Xu          , Xu          , Uu          , Uu          , Xu          , Xu          , Xu          
Xu          , Xu          , Xu          , Xu          , Xu          , Rr          , Uu          , Xu          , Xu          , Xu          , Cud         , Xu          , Xu          , Xu          , Xu          , Wog         , Wog         , Wog         , Wog         , Xu          , Xu          , Xu          , Xu          , Xu          , Xu          , Xu          , Xu          , Uu          , Uu          , Uu          , Uu          , Xu          , Xu          , Xu          , Xu          , Xu          , Uu^Vu       , Xu          , Uu          , Xu          , Xu          , Xu          
Xu          , Xu          , Xu          , Xu          , Xu          , Rr          , Uu          , Uh          , Xu          , Xu          , Cud         , Xu          , Xu          , Xu          , Xu          , Xu          , Xu          , Wog         , Wog         , Wog         , Wog         , Wog         , Wog         , Xu          , Xu          , Xu          , Xu          , Uu          , Uu          , Rr          , Uu          , Uu          , Xu          , Xu          , Xu          , Xu          , Uu          , Uu          , Xu          , Xu          , Xu          , Xu          
Xu          , Xu          , Xu          , Xu          , Xu          , Rr          , Uu          , Uu^Vu       , Xu          , Xu          , Uu          , Xu          , Xu          , Xu          , Xu          , Xu          , Uu^Uf       , Wog         , Wog         , Wog         , Wog         , Wog         , Wog         , Wog         , Xu          , Xu          , Xu          , Uu          , Uu          , Rr          , Rr          , Xu          , Xu          , Xu          , Xu          , Xu          , Xu          , Uu          , Uu          , Xu          , Xu          , Xu          
Xu          , Xu          , Xu          , Uu^Vu       , Uu          , Rr          , Uu          , Xu          , Xu          , Xu          , Uu          , Xu          , Xu          , Xu          , Xu          , Xu          , Xu          , Wog         , Wog         , Wog         , Wog         , Wog         , Wog         , Wog         , Wog         , Xu          , Xu          , Xu          , Uu^Vu       , Uu          , Rr          , Uu          , Uu          , Xu          , Xu          , Xu          , Xu          , Xu          , Xu          , Uu          , Uu          , Xu          
Xu          , Xu          , Xu          , Uu^Uf       , Uu          , Rr          , Uu          , Xu          , Xu          , Xu          , Rr          , Xu          , Xu          , Xu          , Xu          , Xu          , Xu          , Xu          , Xu          , Wog         , Xu          , Wog         , Wog         , Wog         , Wog         , Xu          , Xu          , Xu          , Xu          , Xu          , Uu          , Rr          , Rr          , Uu^Uf       , Xu          , Xu          , Xu          , Xu          , Uu          , Uu          , Xu          , Xu          
Xu          , Xu          , Xu          , Uu          , Uu          , Rr          , Uu          , Uu^Uf       , Xu          , Xu          , Xu          , Rr          , Rr          , Xu          , Uu          , Xu          , Xu          , Xu          , Xu          , Xu          , Xu          , Xu          , Rb          , Wwg         , Wwg         , Xu          , Xu          , Xu          , Xu          , Xu          , Xu          , Uu          , 1 Rr        , Uu          , Uu          , Xu          , Xu          , Uu          , Uu          , Xu          , Xu          , Xu          
Xu          , Xu          , Xu          , Xu          , Uu          , Rr          , Rr          , Uh          , Uu          , Xu          , Xu          , Xu          , Xu          , Rr          , Rr          , Uu          , Uu          , Uu^Vu       , Xu          , Xu          , Xu          , Rb          , Xu          , Wwg^Bw\     , Wwg^Bw\     , Rb          , Uh          , Xu          , Xu          , Xu          , Xu          , Xu          , Uu          , Rr          , Rr          , Xu          , Uu          , Uu          , Uu          , Xu          , Xu          , Xu          
Xu          , Xu          , Xu          , Xu          , Uh          , Uu          , Uu          , Rr          , Rr          , Uu          , Uu          , Xu          , Qxu         , Qxu         , Xu          , Rr          , Uu          , Xu          , Xu          , Xu          , Uu          , Rb          , Xu          , Xu          , Xu          , Rb          , Xu          , Xu          , Xu          , Xu          , Xu          , Xu          , Uu          , Rr          , Rr          , Uu          , Xu          , Uu          , Xu          , Xu          , Xu          , Xu          
Xu          , Xu          , Xu          , Uu^Uf       , Uh          , Uh          , Xu          , Uu          , Uu          , Rr          , Rr          , Uu          , Uu          , Qxu         , Xu          , Xu          , Xu          , Xu          , Rb          , Rb          , Rb          , Rb          , Xu          , Xu          , Wwg         , Rb          , Xu          , Xu          , Xu          , Xu          , Uh          , Uu          , Uu          , Rr          , Uu          , Xu          , Xu          , Xu          , Xu          , Xu          , Xu          , Xu          
Xu          , Xu          , Xu          , Xu          , Xu          , Xu          , Xu          , Uu          , Uu          , Uu          , Uu          , Rr          , Rr          , Re          , Re          , Xu          , Chr         , Xu          , Rb          , Rb          , Xu          , Xu          , Xu          , Xu          , Rb          , Xu          , Xu          , Xu          , Uu^Uf       , Xu          , Xu          , Xu          , Xu          , Uu^Uf       , Wwg^Uf      , Xu          , Rb          , Xu          , Xu          , Xu          , Xu          , Xu          
Xu          , Xu          , Xu          , Xu          , Xu          , Xu          , Xu          , Xu          , Xu          , Xu          , Xu          , Uu          , Uu^Uf       , Re          , Re          , Re          , Re          , Re          , Re          , Xu          , Xu          , Xu          , Wog         , Wwg         , Wwg         , Xu          , Xu          , Xu          , Rb^Uf       , Rb^Uf       , Rb          , Xu          , Xu          , Uu^Uf       , Uu^Vu       , Wwg         , Xu          , Rb          , Xu          , Xu          , Xu          , Xu          
Xu          , Xu          , Xu          , Xu          , Xu          , Xu          , Xu          , Xu          , Xu          , Xu          , Xu          , Xu          , Xu          , Uu^Vu       , Xu          , Re^Uf       , Chr         , Re          , Xu          , Xu          , Xu          , Xu          , Wog         , Wog         , Wwg         , Rb          , Rb          , Rb          , Xu          , Xu          , Xu          , Rb          , Rb          , Xu          , Xu          , Xu          , Wwg         , Rb          , Xu          , Xu          , Xu          , Xu          
Xu          , Xu          , Xu          , Xu          , Xu          , Xu          , Xu          , Xu          , Xu          , Xu          , Xu          , Xu          , Xu          , Xu          , Xu          , Xu          , Xu          , Xu          , Xu          , Xu          , Uu^Uf       , Wog         , Wog         , Wog         , Xu          , Xu          , Uu^Vu       , Xu          , Xu          , Xu          , Xu          , Xu          , Wwg         , Rb          , Wwg         , Rb          , Xu          , Xu          , Xu          , Xu          , Xu          , Xu          
Xu          , Xu          , Xu          , Xu          , Xu          , Xu          , Xu          , Xu          , Xu          , Xu          , Xu          , Xu          , Xu          , Xu          , Xu          , Xu          , Xu          , Xu          , Xu          , Xu          , Xu          , Wog         , Wog         , Xu          , Xu          , Xu          , Xu          , Xu          , Xu          , Xu          , Xu          , Xu          , Xu          , Xu          , Xu          , Xu          , Xu          , Xu          , Xu          , Xu          , Xu          , Xu          
