border_size=1
usage=map

Xu          , Xu          , Xu          , Xu          , Xu          , Xu          , Xu          , Xu          , Xu          , Xu          , Xu          , Xu          , Xu          , Xu          , Xu          , Xu          , Xu          , Xu          , Xu          , Xu          , Xu          , Xu          
Xu          , Xu          , Xu          , Xu          , Xu          , Xu          , Xu          , Xu          , Xu          , Xu          , Xu          , Xu          , Xu          , Xu          , Xu          , Xu          , Xu          , Xu          , Xu          , Xu          , Xu          , Xu          
Xu          , Xu          , Chr         , Chr         , 2 Khr       , Chr         , Chr         , Xu          , Chr         , Xu          , Uu          , Xu          , Xu          , Xu          , Xu          , Xu          , Uu          , Xu          , Uh          , Xu          , Xu          , Xu          
Xu          , Xu          , Urb         , Chr         , Chr         , Chr         , Urb         , Urb         , Xu          , Uu          , Uu^Uf       , Uu          , Uu          , Uu          , Uu          , Uu          , Xu          , Uu          , Uh          , Uh          , Xu          , Xu          
Xu          , Xu          , Xu          , Urb         , Urb         , Chr         , Xu          , Xu          , Uu          , Xu          , Xu          , Uu          , Xu          , Xu          , Xu          , Xu          , Uu^Vu       , Xu          , Xu          , Uu          , Xu          , Xu          
Xu          , Xu          , Uu          , Chr         , Xu          , Xu          , Urb         , Urb         , Xu          , Urb         , Uu          , Uu          , Urb         , Uu          , Uu          , Xu          , Uu          , Xu          , Uu          , Uu          , Xu          , Xu          
Xu          , Uu          , Xu          , Xu          , Xu          , Uu          , Uu          , Xu          , Uu^Vud      , Xu          , Xu          , Xu          , Xu          , Urb         , Uu          , Xu          , Uu          , Uu          , Uu          , Uu^Dr       , Uu          , Xu          
Xu          , Uu          , Uu          , Uu          , Uu          , Urb         , Xu          , Uu          , Uu^Ii       , Xu          , Xu          , Uu^Vu       , Uu          , Xu          , Urb         , Xu          , Xu          , Xu          , Uu          , Uu          , Uu          , Xu          
Xu          , Xu          , Uh          , Xu          , Uu          , Uu          , Urb         , Xu          , Uh          , Urb         , Uu^Ii       , Xu          , Uu          , Xu          , Urb         , Uu          , Uu          , Xu          , Uu          , Uu          , Uu          , Xu          
Xu          , Xu          , Uh          , Xu          , Uu          , Uu          , Xu          , Urb         , Uu          , Xu          , Uu^Ii       , Xu          , Xu          , Uu          , Xu          , Uu          , Urb         , Xu          , Uu          , Uu^Uf       , Uu^Uf       , Xu          
Xu          , Xu          , Uh          , Xu          , Uu          , Xu          , Uu^Vu       , Xu          , Uu          , Xu          , Uu^Uf       , Xu          , Uu          , Uu^Uf       , Xu          , Uu          , Urb         , Uu          , Uu          , Uu^Uf       , Uu          , Xu          
Xu          , Xu          , Xu          , Uu          , Uu          , Xu          , Uu          , Xu          , Urb         , Xu          , Uu          , Uu          , Xu          , Uu          , Xu          , Xu          , Urb         , Xu          , Uu          , Uh          , Uu          , Xu          
Xu          , Xu          , Uu^Uf       , Xu          , Uu          , Xu          , Uu          , Xu          , Urb         , Xu          , Xu          , Urb         , Xu          , Uu^Vu       , Xu          , Xu          , Uu          , Xu          , Uu          , Uh          , Uu          , Xu          
Xu          , Xu          , Xu          , Uu          , Uu          , Xu          , Uu          , Uh          , Urb         , Uu          , Uu          , Urb         , Xu          , Xu          , Urb         , Urb         , Xu          , Xu          , Uu          , Uu          , Uu          , Xu          
Xu          , Xu          , Xu          , Uh          , Uu          , Uu          , Uu          , Xu          , Uu          , Xu          , Xu          , Uu          , Urb         , Xu          , Uu          , Xu          , Uu          , Xu          , Uu          , Uu          , Xu          , Xu          
Xu          , Xu          , Uu          , Uu          , Xu          , Xu          , Uu          , Xu          , Urb         , Uu^Uf       , Xu          , Xu          , Uu^Vu       , Urb         , Xu          , Uu          , Uu          , Xu          , Xu          , Uu          , Xu          , Xu          
Xu          , Uu          , Xu          , Xu          , Uu^Vu       , Uu          , Xu          , Xu          , Uu^Ii       , Xu          , Xu          , Xu          , Xu          , Xu          , Xu          , Uu          , Xu          , Xu          , Uu          , Uu          , Xu          , Xu          
Xu          , Uu          , Uu^Uf       , Xu          , Xu          , Uu          , Uu          , Uu          , Uu          , Uu          , Urb         , Uu          , Uu^Dr       , Xu          , Uu          , Uu          , Uu          , Uu          , Xu          , Xu          , Xu          , Xu          
Xu          , Xu          , Uu          , Xu          , Uu          , Uu          , Xu          , Xu          , Uu          , Uu          , Xu          , Urb         , Urb         , Uu          , Uu          , Xu          , Xu          , Xu          , Uu^Uf       , Uu^Vu       , Xu          , Xu          
Xu          , Xu          , Xu          , Uu          , Uh          , Xu          , Uu          , Uu          , Uh          , Uu          , Uu          , Xu          , Xu          , Urb         , Urb         , Uu          , Uu          , Uu          , Uu          , Uu          , Xu          , Xu          
Xu          , Xu          , Xu          , Xu          , Xu          , Uu          , Uu          , Uu          , Uu^Uf       , Uu          , Xu          , Uu          , Uu^Vu       , Xu          , Xu          , Urb         , Urb         , Uu          , Rr          , 1 Uu        , Uu          , Xu          
Xu          , Xu          , Xu          , Xu          , Xu          , Xu          , Xu          , Xu          , Xu          , Xu          , Xu          , Xu          , Xu          , Xu          , Xu          , Xu          , Xu          , Xu          , Xu          , Xu          , Xu          , Xu          
