border_size=1
usage=map

Xu          , Xu          , Xu          , Xu          , Xu          , Xu          , Xu          , Xu          , Xu          , Xu          , Xu          , Xu          , Xu          , Xu          , Xu          , Xu          , Xu          , Xu          , Xu          , Xu          , Xu          , Xu          
Xu          , Xu          , Xu          , Xu          , Xu          , Xu          , Xu          , Xu          , Xu          , Xu          , Urb         , Urb         , Urb         , Xu          , Uh          , Xu          , Xu          , Xu          , Xu          , Xu          , Xu          , Xu          
Xu          , Xu          , Xu          , Xu          , Xu          , Uh          , Re          , Uue^Uf      , Uue^Uf      , Uu          , Uu          , Urb         , Uu          , Uu          , Uh          , Uh          , Re          , Uh          , Xu          , Xu          , Xu          , Xu          
Xu          , Xu          , Xu          , Xu          , Ds          , Ds          , Ds          , Re          , Re          , Uue         , Uue         , Uu          , Uh          , Uh          , Uue         , Re          , Ds^Dr       , Ds          , Ds          , Xu          , Xu          , Xu          
Xu          , Xu          , Xu          , Ds          , Ds          , Ds          , Ds^Dr       , Ds          , Ds          , Re          , Re          , Uue         , Uu          , Uu          , Uue         , Re          , Re          , Ds          , Ds          , Xu          , Xu          , Xu          
Xu          , Xu          , Xu          , Ds          , Ds          , Ds          , Re          , Ds          , Ds          , Re          , Urb         , Urb         , Urb         , Uu          , Uu          , Uue         , Re          , Ds          , Re          , Xu          , Xu          , Xu          
Xu          , Xu          , Xu          , Re          , Re          , Re          , Urb         , Ds          , Rd          , Rd          , Ds          , Re          , Uu          , Uu          , Uh          , Uue         , Xu          , Re          , Uh          , Xu          , Xu          , Xu          
Xu          , Xu          , Xu          , Uue         , Uue         , Uue         , Urb         , Urb         , Re          , Ds          , Uu          , Uh          , Uh          , Re          , Re          , Uh          , Uh          , Xu          , Xu          , Xu          , Xu          , Xu          
Xu          , Xu          , Xu          , Xu          , Uu          , Uu          , Uh          , Urb         , Urb         , Uu          , Uue         , Uh          , Xu          , Ds          , Ds          , Re          , Uue         , Uh          , Uh          , Xu          , Xu          , Xu          
Xu          , Xu          , Wwg         , Uue         , Uue         , Uh          , Uh          , Uu          , Uu          , Urb         , Uue^Vu      , Xu          , Xu          , Xu          , Ds          , Re          , Uue         , Uh          , Xu          , Xu          , Xu          , Xu          
Xu          , Xu          , Ww^Vm       , Wwg         , Wwg         , Uue         , Uu          , Uu          , Uu^Uf       , Uu          , Urb         , Ds          , Ds          , Xu          , Ds^Dr       , Re          , Re          , Uue         , Uh          , Xu          , Xu          , Xu          
Xu          , Wwg         , Wwg         , Wwg         , Uue         , Xu          , Uu          , Uu^Uf       , Uu^Uf       , Uu          , Urb         , Re          , Re          , Ds          , Re          , Ds          , Ds          , Re          , Uue         , Uh          , Uh          , Xu          
Xu          , Xu          , Xu          , Uue         , Xu          , Uu          , Uu          , Uh          , Uu          , Uu          , Urb         , Urb         , Urb         , Re          , Uue         , Re          , Re          , Re          , Uue         , Uh          , Uh          , Xu          
Xu          , Xu          , Xu          , Xu          , Xu          , Uh          , Uu          , Uu          , Uu          , Uu          , Urb         , Uue         , Uue         , Urb         , Urb         , Uue         , Uu          , Uue         , Uu          , Uu          , Xu          , Xu          
Xu          , Xu          , Xu          , Xu          , Xu          , Uh          , Uu          , Uu^Dr       , Urb         , Urb         , Re          , Re          , Re          , Uue         , Uue         , Uu          , Uu          , Xu          , Xu          , Xu          , Xu          , Xu          
Xu          , Xu          , Xu          , Xu          , Uh          , Uu          , Uu          , Uu          , Uu          , Uue         , Re          , Ds          , Ds          , Re          , Re          , Uue         , Uue         , Xu          , Xu          , Xu          , Xu          , Xu          
Xu          , Xu          , Xu          , Uh          , Uh          , Uu          , Uh          , Uh          , Uu          , Uue         , Uue         , Re          , Ds^Dr       , Ds          , Ds          , Re          , Re          , Uue         , Uue         , Xu          , Xu          , Xu          
Xu          , Xu          , Xu          , Uh          , Uu          , Uu          , Uu          , Uh          , Uu          , Uu^Uf       , Uue         , Re          , Re          , Ds          , Ds          , Ds          , Ds          , Re          , Re          , Xu          , Xu          , Xu          
Xu          , Xu          , Uh          , Uu          , Uu          , Uu^Uf       , Uu^Uf       , Uu          , Uh          , Uu^Uf       , Uu          , Uue         , Uue         , Re          , Ds          , 1 Dd^Dc     , Ds          , Ds          , Xu          , Xu          , Xu          , Xu          
Xu          , Xu          , Uh          , Uu          , Uu          , Uu^Uf       , Uh          , Uh          , Uh          , Uu          , Uu          , Uu          , Urb         , Re          , Ds          , Ds          , Xu          , Xu          , Xu          , Xu          , Xu          , Xu          
Xu          , Xu          , Xu          , Uh          , Xu          , Xu          , Xu          , Xu          , Xu          , Uh          , Xu          , Urb         , Urb         , Urb         , Xu          , Xu          , Xu          , Xu          , Xu          , Xu          , Xu          , Xu          
Xu          , Xu          , Xu          , Xu          , Xu          , Xu          , Xu          , Xu          , Xu          , Xu          , Xu          , Xu          , Xu          , Xu          , Xu          , Xu          , Xu          , Xu          , Xu          , Xu          , Xu          , Xu          
