border_size=1
usage=map

Gs          , Gs          , Gs          , Gs          , Gs          , Gs          , Gs          , Aa          , Aa          , Aa          , Aa          , Aa          , Aa          , Aa          , Aa          , Aa          , Aa          , Aa          , Aa          , Aa          , Aa          , Aa          
Gs          , Gs          , Gs          , Gs          , Gs          , Gs          , Gs          , Gs          , Gs          , Gs          , Gs          , Aa          , Gs          , Aa          , Gs          , Aa          , Aa          , Aa          , Aa          , Aa          , Gs          , Gs          
Gs          , Gs          , Gs          , Gs          , Rr          , Rr          , Rr          , Rr          , Rr          , Gs          , Rr          , Rr          , Rr          , Gs          , Rr          , Gs          , Gs          , Aa          , Gs          , Gs          , Rr          , Gs          
Rb          , Rr          , Rr          , Rr          , Rr          , Rr          , Rr          , Rr          , Rr          , Rr          , Rr          , Rr          , Rr          , Rr          , Rr          , Gs          , Gs          , Gs          , Gs          , Rr          , Rr          , Rr          
Rb          , Rr          , Rr          , Rr          , Rr          , Rr          , Rr          , Rr          , Rr          , Rr          , Rr          , Rr          , Rr          , Rr          , Rr          , Gs          , Gs          , Gs          , Gs          , Rr          , Rr          , Rr          
Rb          , Rr          , Rr          , Rr          , Rr          , Rr          , Rr          , Rr          , Rr          , Rr          , Rr          , Rr          , Aa          , Rr          , Aa          , Rr          , Gs          , Gs          , Gs          , Rr          , Rr          , Rr          
Rb          , Rr          , Rr          , Rr          , Rr          , Rr          , Ch          , Rr          , Ch          , Ch          , Ch          , Rr          , Aa          , Aa          , Aa          , Aa          , Gs          , Gs          , Gs          , Rr          , Rr          , Rr          
Rb          , Rb          , Rb          , Rr          , Ch          , Ch          , Rrc         , Ch          , Rrc         , Rrc         , Rrc         , Ch          , Ch          , Ch          , Ch          , Aa          , Aa          , Gs          , Rr          , Rr          , Rr          , Rr          
Aa          , Aa          , Rb          , Ch          , Rrc         , Rrc         , Rrc         , Rrc         , Rrc         , Ch          , Rrc         , Rrc         , Rrc         , Rrc         , Rrc         , Ch          , Aa          , Aa          , Rr          , Rr          , Rr          , Rr          
Aa          , Rb          , Rr          , Ch          , Rrc         , Rrc         , Rrc         , Rrc         , Ch          , 3 Kh        , Ch          , Rrc         , Rrc         , Rrc         , Rrc         , Ch          , Aa          , Aa          , Rr          , Rr          , Rr          , Rr          
Aa          , Rb          , Rr          , Ch          , Rrc         , Rrc         , Rrc         , Rrc         , Rrc         , Rrc         , Rrc         , Rrc         , Rrc         , Rrc         , Rrc         , Ch          , Aa          , Aa          , Rr          , Rr          , Rr          , Rr          
Rb          , Rb          , Rr          , Ch          , Rrc         , 4 Ch        , Rrc         , Rrc         , Rrc         , Rrc         , Rrc         , Rrc         , Rrc         , Ch          , Rrc         , Ch          , Aa          , Aa          , Rr          , Rr          , Re          , Rr          
Rb          , Rr          , Rr          , Ch          , Rr          , Rr          , Rrc         , Rrc         , 1 Rrc       , Rrc         , 2 Rrc       , Rrc         , Rr          , Rr          , Rr          , Ch          , Aa          , Aa          , Rr          , Rr          , Re          , Re          
Rb          , Rr          , Rr          , Ch          , Ch          , Rr          , Rr          , Rrc         , Rrc         , Rrc         , Rrc         , Rr          , Rr          , Rr          , Ch          , Ch          , Rr          , Rr          , Rr          , Rr          , Re          , Re          
Ai          , Rb          , Rb          , Rr          , Ch          , Ch          , Ch          , Rr          , Rr          , Rrc         , Rr          , Rr          , Ch          , Ch          , Ch          , Rr          , Rr          , Rr          , Rr          , Rr          , Re          , Re          
Ai          , Ai          , Rb          , Rr          , Rr          , Ch          , Rp          , Rp          , Rr          , Rrc         , Rr          , Rr          , Rr          , Ch          , Rr          , Rr          , Rr          , Rr          , Rr          , Re          , Re          , Re          
Ai          , Ai          , Ai          , Rb          , Rb          , Rr          , Rr          , Rp          , Rp          , Rrc         , Rr          , Rp          , Rr          , Rr          , Rr          , Rr          , Rr          , Rr          , Re          , Re          , Gll         , Re          
Gs          , Ai          , Ai          , Ai          , Rb          , Rb          , Rb          , Rp          , Rp          , Rr          , Rr          , Rp          , Rp          , Rr          , Rr          , Rr          , Rr          , Rr          , Re          , Gg          , Aa          , Gg          
Gs          , Gs          , Gs          , Ai          , Gs          , Re          , Re          , Rb          , Rp          , Rr          , Rr          , Rp          , Rp          , Rp          , Rp          , Rr          , Re          , Re          , Gll         , Gll         , Aa          , Aa          
Gs          , Gs          , Gs          , Gs          , Gs          , Gs          , Re          , Rb          , Rb          , Rp          , Rr          , Rp          , Rp          , Rp          , Re          , Re          , Re          , Re          , Gg          , Aa          , Aa          , Aa          
Aa          , Gs          , Gs          , Gs          , Gs          , Gs          , Gs          , Re          , Rb          , Rp          , Rr          , Rr          , Rp          , Re          , Re          , Re          , Re          , Gll         , Aa          , Aa          , Aa          , Aa          
Aa          , Aa          , Aa          , Gs          , Gs          , Gs          , Gs          , Re          , Rb          , Rp          , Rr          , Rr          , Rp          , Rp          , Re          , Re          , Re          , Aa          , Aa          , Aa          , Aa          , Aa          
