border_size=1
usage=map

Ai          , Ai          , Ai          , Ai          , Ai          , Ai          , Ai          , Ai          , Ai          , Ai          , Ai          , Ai          , Ai          , Ai          , Ai          , Ai          , Ai          , Ai          , Ai          , Ai          , Ai          , Ai          , Ai          , Ai          , Ai          , Ai          , Ai          , Ai          , Ai          , Ai          , Ai          , Ai          , Ai          , Ai          , Ai          , Aa          , Aa          , Aa          , Aa          , Aa          , Aa          , Aa          
Ai          , Ai          , Ai          , Ai          , Cha         , Ai          , Cha         , Ai          , Cha         , Ai          , Ai          , Ai          , Ai          , Ai          , Ai          , Ai          , Ai          , Ai          , Ai          , Ai          , Ai          , Aa          , Ai          , Ai          , Ai          , Ai          , Cha         , Wo          , Cha         , Ai          , Ai          , Ai          , Ai          , Aa          , Aa          , Aa          , Aa          , Aa          , Aa          , Aa          , Aa          , Aa          
Ai          , Ai          , Aa          , Ai          , Cha         , Cha         , Cha         , Cha         , Ai          , Cha         , Cha         , Cha         , Cha         , Cha         , Cha         , Cha         , Cha         , Cha         , Cha         , Cha         , Cha         , Cha         , Cha         , Cha         , Cha         , Cha         , Cha         , Cha         , Cha         , Cha         , Cha         , Cha         , Cha         , Cha         , Cha         , Wo          , Cha         , Ai          , Ai          , Ai          , Aa          , Aa          
Aa          , Aa          , Aa          , Ai          , Cha         , Aa          , Aa          , Ai          , Ai          , Aa          , Rp          , Rp          , Rp          , Rp          , Rp          , Aa          , Rp          , Cha         , Aa          , Rp          , Aa          , Cha         , Rp          , Cha         , Aa          , Aa          , Aa          , Ai          , Aa          , Aa          , Aa          , Aa          , Aa          , Aa          , Aa          , Cha         , Rp          , Cha         , Cha         , Ai          , Aa          , Aa          
Aa          , Aa          , Aa          , Ai          , Cha         , Aa          , Aa          , Aa          , Aa          , Aa          , Aa          , Rp          , Chr         , Chr         , Chr         , Aa          , Aa          , Aa          , Rp          , Aa          , Rp          , Aa          , Rp          , Aa          , Aa          , Aa          , Rp          , Aa          , Aa          , Aa          , Aa          , Aa          , Aa          , Aa          , Aa          , Aa          , Ch          , Rp          , Cha         , Ai          , Aa          , Aa          
Aa          , Aa          , Aa          , Ai          , Chr         , Aa          , Aa^Vha      , Aa^Vha      , Aa^Vha      , Aa          , Aa          , Rp          , Rp          , Rd          , Chr         , Aa          , Rp          , Rp          , Cha         , Cha         , Chr         , Rp          , Rp          , Aa          , Rp          , Ch          , Rp          , Aa          , Aa          , Aa          , Rrc^Vhca    , Aa          , Aa          , Aa          , Aa          , Aa          , Aa          , Aa          , Cha         , Ai          , Aa          , Aa          
Aa          , Aa^Fpa      , Ai          , Ai          , Cha         , Aa          , Aa          , Aa          , Aa          , Aa          , Aa          , Aa          , Aa          , Rp          , Aa          , Aa          , Cha         , Cha         , Rrc         , 2 Khr       , Rrc         , Rd          , Chr         , Rp          , Rp          , Rp          , Aa          , Aa          , Gg^Fet      , Gg^Fet      , Rr^Vhc      , Rr          , Rr          , Aa          , Aa          , Aa          , Aa          , Aa          , Cha         , Ai          , Aa          , Aa          
Aa          , Aa^Fpa      , Ai          , Ai          , Chr         , Aa          , Aa          , Aa          , Rr          , Rrc^Vhca    , Rrc^Vhca    , Ai          , Ai          , Aa          , Aa          , Rp          , Rp          , Cha         , Aa          , Rrc         , Rrc         , Chr         , Rp          , Rp          , Aa          , Aa          , Aa          , Aa          , Rrc^Vhca    , Rr^Vhc      , Rr          , Rr          , Aa          , Rrc^Vhca    , Aa          , Aa          , Aa          , Aa          , Cha         , Ai          , Aa          , Aa          
Aa          , Aa^Fpa      , Ai          , Ai          , Rd          , Aa          , Aa          , Aa          , Cha         , Rr          , Rr          , Rrc^Vhca    , Rrc^Vhca    , Ai          , Aa          , Ai          , Rp          , Chr         , Ai          , Aa          , Aa          , Cha         , Rp          , Rp          , Aa          , Ai          , Rr          , Rr          , Rr          , Rr          , Gg^Es       , Rrc^Vhca    , Aa          , Aa          , Cea         , Aa          , Aa          , Aa          , Cha         , Ai          , Aa          , Aa          
Aa          , Aa^Fpa      , Re          , Wwf         , Ai          , Chr         , Aa          , 3 Kha       , Cha         , Cha         , Aa          , Rr          , Rr          , Re          , Aa          , Aa          , Rp          , Rd          , Ai          , Ai          , Ai          , Cha         , Aa          , Aa          , Aa          , Rr          , Rr          , Rr^Es       , Aa          , Gg          , Gg          , Rp          , Aa          , Cha         , Kh          , Cea         , Aa          , Aa          , Cha         , Ai          , Aa          , Aa          
Re          , Re          , Re          , Ai          , Ai          , Rd          , Chr         , Aa          , Aa          , Aa          , Rd          , Rp          , Rp          , Rr          , Aa          , Aa          , Aa          , Chr         , Aa          , Ai          , Aa          , Cha         , Aa          , Aa          , Rr          , Rr          , Aa          , Aa          , Ai          , Aa          , Aa          , Aa          , Aa          , Cha         , Cea         , Cea         , Aa          , Aa          , Cha         , Ai          , Aa          , Aa          
Re          , Re          , Aa^Fpa      , Ai          , Ai          , Ai          , Ai          , Cha         , Cha         , Aa          , Cha         , Rp          , Aa          , Aa          , Aa          , Aa          , Aa          , Cha         , Rrc         , Cha         , Rrc         , Cha         , Rr          , Rr          , Rp          , Rp          , Aa          , Aa          , Ai          , Aa          , Aa          , Aa          , Aa          , Aa          , Aa          , Aa          , Cha         , Cha         , Ai          , Ai          , Aa          , Aa          
Aa          , Aa^Fpa      , Aa^Fpa      , Ai          , Ai          , Ai          , Ai          , Ai          , Ai          , Cha         , Ai          , Cha         , Cha         , Aa          , Cha         , Cha         , Cha         , Rr          , Rr          , Rr          , Rr          , Rr          , Cha         , Cha         , Cha         , Rp          , Cha         , Ai          , Cha         , Ai          , Cha         , Aa          , Cha         , Aa          , Cha         , Cha         , Cha         , Ai          , Ai          , Ai          , Aa          , Aa          
Aa          , Aa          , Aa          , Ai          , Aa          , Ai          , Aa          , Ai          , Ai          , Ai          , Aa          , Ai          , Ai          , Cha         , Ai          , Cha         , Ai          , Cha         , Wo^Bw|      , Wo^Bw|      , Wo^Bw|      , Cha         , Ai          , Cha         , Ai          , Cha         , Ai          , Cha         , Ai          , Cha         , Ww          , Cha         , Ai          , Cha         , Ai          , Ai          , Ai          , Ai          , Ai          , Ai          , Aa          , Aa          
Aa          , Aa^Fpa      , Aa          , Aa          , Aa          , Aa          , Aa          , Ai          , Aa          , Ai          , Aa          , Aa          , Aa          , Ai          , Aa          , Ai          , Ai          , Ai          , Wo^Bw|      , Wo^Bw|      , Wo^Bw|      , Ai          , Ai          , Ai          , Ai          , Ai          , Ai          , Ai          , Ai          , Wo          , Ds          , Wo          , Ai          , Ai          , Ai          , Ai          , Aa          , Ai          , Ai          , Ww          , Aa          , Aa          
Ha          , Ha          , Ha          , Aa          , Aa          , Aa          , Aa          , Aa          , Aa          , Aa          , Aa          , Aa          , Aa          , Aa          , Aa          , Aa          , Re          , Rd          , Wo^Bw|      , Wo^Bw|      , Wo^Bw|      , Rd          , Re          , Aa          , Aa          , Aa          , Aa          , Aa          , Aa          , Aa          , Ds          , Ai          , Ai          , Ai          , Ai          , Aa          , Aa          , Aa          , Ai          , Ai          , Aa          , Aa          
Ha          , Ms          , Ms          , Ha          , Ha          , Aa          , Aa          , Aa          , Aa          , Aa          , Aa          , Aa          , Aa^Fpa      , Aa          , Aa          , Aa          , Re          , Rd          , Rd          , Rd          , Rd          , Rd          , Re          , Aa          , Aa          , Aa          , Aa          , Aa          , Aa          , Ds          , Aa          , Aa          , Aa          , Aa          , Aa          , Aa          , Aa^Vha      , Aa^Fpa      , Ai          , Ai          , Aa^Fpa      , Aa          
Ha          , Ms          , Ms          , Ms          , Ms          , Ha          , Aa^Fpa      , Aa^Fpa      , Aa^Vha      , Aa          , Aa          , Aa^Fpa      , Aa^Fpa      , Aa^Fpa      , Aa^Fpa      , Aa          , Aa          , Re          , Re          , Rd^Es       , Rd          , Rd          , Re          , Aa          , Aa          , Aa          , Aa          , Aa          , Aa          , Aa          , Aa^Fpa      , Aa          , Aa^Fpa      , Aa          , Aa^Fpa      , Aa^Fpa      , Aa          , Aa^Fpa      , Ww          , Ai          , Aa^Fpa      , Aa          
Ha          , Ms          , Ms          , Ms          , Ms          , Ha          , Aa^Fpa      , Aa^Fpa      , Aa          , Aa          , Aa^Fpa      , Aa^Fpa      , Aa^Fpa      , Aa^Fpa      , Aa^Fpa      , Aa^Vha      , Aa^Fpa      , Re          , Re          , Rd          , Re          , Re^Es       , Aa          , Aa^Fpa      , Aa^Fpa      , Aa^Fpa      , Aa^Fpa      , Aa^Vha      , Aa          , Aa^Fpa      , Aa^Fpa      , Aa^Fpa      , Aa^Fpa      , Aa^Fpa      , Aa^Fpa      , Aa^Fpa      , Aa^Fpa      , Aa^Fpa      , Ai          , Ai          , Ai          , Aa          
Ha          , Mm^Xm       , Mm^Xm       , Ms          , Ms          , Ha          , Aa^Fpa      , Aa^Fpa      , Aa          , Aa          , Aa^Fpa      , Aa^Fpa      , Aa^Fpa      , Aa^Fpa      , Aa^Fpa      , Aa^Fpa      , Aa^Fpa      , Aa          , Re          , Re          , Re          , Re          , Aa          , Aa          , Aa^Fpa      , Aa^Fpa      , Aa^Fpa      , Aa^Fpa      , Aa^Fpa      , Aa          , Aa          , Aa^Fpa      , Aa^Fpa      , Aa^Fpa      , Aa^Fpa      , Aa^Fpa      , Aa^Fpa      , Aa^Fpa      , Ai          , Ww          , Ai          , Ai          
Ha          , Mm^Xm       , Mm^Xm       , Ms          , Ha          , Ha          , Aa          , Aa          , Aa          , Aa^Fpa      , Aa^Fpa      , Aa^Fpa      , Aa^Fpa      , Aa^Fpa      , Aa^Fpa      , Aa^Fpa      , Aa^Fpa      , Aa          , Aa          , Cea         , 1 Kea       , Cea         , Aa          , Aa          , Aa^Fpa      , Aa^Fpa      , Aa^Fpa      , Aa^Fpa      , Aa^Fpa      , Aa^Fpa      , Aa^Fpa      , Aa          , Aa^Vha      , Aa^Fpa      , Aa^Fpa      , Aa^Fpa      , Aa^Fpa      , Aa^Fpa      , Ai          , Ai          , Ai          , Ai          
Ha          , Mm^Xm       , Mm^Xm       , Ms          , Ha          , Ha          , Aa          , Aa          , Aa          , Aa^Fpa      , Aa^Fpa      , Aa^Fpa      , Aa^Fpa      , Aa^Fpa      , Aa^Fpa      , Aa^Fpa      , Aa^Fpa      , Aa^Fpa      , Aa          , Re          , Cea         , Re          , Aa          , Aa          , Aa^Fpa      , Aa^Fpa      , Aa^Fpa      , Aa^Fpa      , Aa^Fpa      , Aa^Fpa      , Aa^Fpa      , Aa^Fpa      , Aa^Fpa      , Aa^Fpa      , Aa^Fpa      , Aa^Fpa      , Aa^Fpa      , Aa^Fpa      , Ai          , Ai          , Ai          , Ai          
