border_size=1
usage=map

Wog         , Wog         , Wog         , Wog         , Wog         , Wog         , Wog         , Wog         , Wog         , Wog         , Wog         , Wog         , Wog         , Wog         , Wog         , Wog         , Wog         , Wog         , Wog         , Wog         , Wog         , Wog         , Wog         , Wog         , Rrc         , Rrc         , Rrc         , Wog         , Wog         , Wog         , Wog         , Wog         , Wog         , Wog         , Wog         , Wog         , Wog         , Wog         , Wog         , Wog         , Wog         , Wog         , Wog         , Wog         , Wog         , Wog         
Wog         , Wog         , Wog         , Wog         , Wog         , Wog         , Wog         , Wog         , Wog         , Wog         , Wog         , Wog         , Wog         , Wog         , Wog         , Wog         , Wog         , Wog         , Wog         , Wog         , Rrc         , Wog         , Wog         , Wog         , Rrc^Xo      , Rrc^Xo      , Rrc^Xo      , Wog         , Wog^Xo      , Wog         , Wog^Xo      , Wog         , Wog         , Wog         , Wog         , Wog         , Wog         , Wog         , Wog         , Wog         , Wog         , Wog         , Wog         , Wog         , Wog         , Wog         
Wog^Xo      , Wog         , Wog         , Wog         , Wog         , Wog         , Wog         , Wog         , Wog         , Wog         , Wog         , Wog         , Wog         , Wog         , Wog         , Wog         , Wog         , Wog         , Wog         , Rrc         , Rrc^Xo      , Rrc^Xo      , Rrc^Xo      , Wog^Xo      , Wog^Xo      , 2 Rrc       , Wog^Xo      , Wog^Xo      , Wog         , Wog^Xo      , Wog^Xo      , Wog^Xo      , Rrc^Xo      , Wog         , Wog         , Wog         , Wog         , Wog         , Wog         , Wog         , Wog         , Wog         , Wog         , Wog         , Wog         , Wog         
Wog         , Wog^Xo      , Wog^Xo      , Wog         , Wog         , Wog         , Wog         , Wog         , Wog         , Wog         , Wog         , Wog         , Wog         , Wog         , Wog         , Wog         , Wog         , Wog^Xo      , Wog         , Rrc^Xo      , Rrc         , Rrc         , Rrc         , Aa          , Aa          , Wog^Xo      , Aa          , Wog         , Rrc         , Rrc         , Rrc         , Rrc         , Rrc         , Rrc^Xo      , Rrc         , Wog         , Wog         , Wog         , Wog         , Wog         , Wog         , Wog         , Wog         , Wog         , Wog^Xo      , Wog^Xo      
Wog^Xo      , Wog         , Wog         , Wog^Xo      , Wog^Xo      , Wog         , Wog         , Wog         , Wog^Xo      , Wog         , Wog^Xo      , Wog         , Wog^Xo      , Wog         , Wog         , Wog         , Wog         , Wog^Xo      , Rrc         , Rrc         , Rrc         , Rrc         , Rrc         , Rrc         , Rrc         , Rrc^Xo      , Ycsl        , Rrc         , Rrc         , Rrc         , Rrc         , Rrc         , Rrc         , Rrc^Xo      , Rrc         , Wog         , Wog         , Wog         , Wog         , Wog         , Wog         , Wog         , Wog^Xo      , Wog^Xo      , Wog         , Wog         
Ai          , Wog         , Wog         , Wog         , Wog         , Wog^Xo      , Wog         , Wog^Xo      , Wog         , Wog^Xo      , Wog         , Wog^Xo      , Wog         , Wog^Xo      , Wog^Xo      , Wog         , Wog^Xo      , Wog^Xo      , Wog         , Rrc         , Rb          , Rrc^Ycsg    , Rb          , Rrc         , Rrc         , Rrc^Xo      , Aa          , Rrc         , Rb          , Rrc^Ycsg    , Rb          , Rrc         , Rrc         , Rrc^Xo      , Aa^Xo       , Rrc         , Wog^Xo      , Wog         , Wog^Xo      , Wog         , Wog^Xo      , Wog^Xo      , Wog         , Wog         , Wog         , Wog         
Aa          , Ai          , Ai          , Wog         , Wog         , Wog         , Wog         , Wog         , Wog         , Wog         , Wog         , Wog         , Wog         , Wog         , Wog         , Wog^Xo      , Wog^Xo      , Wog^Xo      , Wog^Xo      , Rrc^Xo      , Rb^Xo       , Rb^Xo       , Ai^Xo       , Rb^Xo       , Wog^Xo      , Wog^Xo      , Wog^Xo      , Rb^Xo       , Ai^Xo       , Rb^Xo       , Rb^Xo       , Rb^Xo       , Wog^Xo      , Rrc^Xo      , Wog         , Wog^Xo      , Wog         , Wog^Xo      , Wog         , Wog^Xo      , Wog         , Wog         , Wog         , Wog         , Ai          , Ai          
Aa          , Aa          , Aa          , Ai          , Ai          , Wog         , Ai          , Ai          , Ai          , Wog         , Ai          , Wog         , Ai          , Wog         , Ai          , Wog         , Wog         , Wog         , Wog         , Wog         , Ai^Bw|      , Ai^Bw|      , Ai^Bw|      , Wog         , Wog         , Wog         , Wog         , Wog         , Ai^Bw|      , Ai^Bw|      , Ai^Bw|      , Wog         , Wog         , Wog         , Wog         , Wog         , Wog         , Wog         , Wog         , Wog         , Wog         , Wog         , Ai          , Ai          , Ai          , Ai          
Aa          , Aa          , Aa^Fpa      , Aa          , Aa^Fpa      , Ai          , Aa          , Ai          , Aa          , Ai          , Aa          , Ai          , Aa          , Ai          , Ai          , Ai          , Ai          , Ai          , Ai          , Ai          , Ai^Bw|      , Ai^Bw|      , Ai^Bw|      , Ai          , Ai          , Wog         , Ai          , Ai          , Ai^Bw|      , Ai^Bw|      , Ai^Bw|      , Ai          , Ai          , Wog         , Ai          , Wog         , Ai          , Wog         , Ai          , Wog         , Ai          , Ai          , Aa          , Ai          , Aa          , Aa          
Aa          , Aa          , Aa^Fpa      , Aa^Fpa      , Ha^Fpa      , Aa^Fpa      , Aa^Fpa      , Aa          , Aa          , Aa          , Aa          , Aa          , Aa          , Aa          , Aa          , Ai          , Aa          , Ai          , Ai          , Ai          , Aa^Bw|      , Ai^Bw|      , Aa^Bw|      , Ai          , Ai          , Ai          , Ai          , Ai          , Aa^Bw|      , Ai^Bw|      , Aa^Bw|      , Ai          , Ai          , Ai          , Ai          , Ai          , Ai          , Ai          , Aa          , Ai          , Aa          , Aa          , Aa          , Aa          , Aa          , Aa          
Aa          , Aa^Fpa      , Aa^Fpa      , Ha^Fpa      , Ha^Fpa      , Ha^Fpa      , Aa^Fpa      , Aa          , Aa          , Aa          , Aa          , Aa          , Aa          , Aa          , Aa          , Aa          , Rrc^Vhca    , Aa          , Aa          , Aa          , Rrc         , Rrc^Bw|     , Rrc         , Aa          , Aa          , Aa          , Aa          , Ai          , Rrc         , Rrc^Bw|     , Rrc         , Aa          , Aa          , Aa          , Aa^Fpa      , Aa          , Aa          , Aa          , Aa          , Aa          , Gs^Vh       , Aa          , Re^Gvs      , Aa          , Aa          , Aa          
Aa          , Aa          , Aa          , Aa^Fpa      , Aa^Fpa      , Aa^Fpa      , Aa^Fpa      , Aa^Fpa      , Aa^Fda      , Aa          , Aa          , Aa          , Aa          , Aa          , Aa          , Aa          , Aa          , Rr          , Rr          , Rr          , Rb          , Rrc^Bw|     , Rrc         , Aa          , Cha         , Cha         , Cha         , Aa          , Rrc         , Rrc^Bw|     , Rrc         , Aa          , Aa          , Aa          , Aa          , Aa          , Aa          , Aa          , Re          , Re          , Re^Gvs      , Re^Gvs      , Re^Gvs      , Re^Gvs      , Aa          , Aa          
Aa          , Aa          , Ha          , Aa          , Aa          , Aa^Fpa      , Aa^Fpa      , Aa^Fda      , Aa^Fpa      , Aa^Fda      , Aa^Fpa      , Aa          , Aa          , Aa          , Re          , Rrc^Vhca    , Re          , Rp          , Rb          , Rr^Vhc      , Rb          , Rrc         , Rrc         , Aa          , Ch          , 4 Kha       , Cha         , Aa          , Rrc         , Rrc         , Rr          , Aa          , Aa^Fpa      , Aa          , Aa          , Aa          , Re          , Re          , Re^Gvs      , Re^Gvs      , Re^Gvs      , Re^Gvs      , Re^Gvs      , Re^Gvs      , Aa          , Aa          
Aa          , Aa          , Ha          , Ha          , Aa          , Aa          , Aa          , Aa^Fda      , Aa          , Aa^Fpa      , Aa          , Aa          , Aa          , Re          , Re^Gvs      , Re          , Re^Gvs      , Re          , Re          , Rb          , Rb          , Re          , Rrc         , Rb          , Rrc         , Ch          , Aa          , Aa          , Rb          , Rr          , Rb          , Aa          , Aa          , Aa          , Re          , Re          , Re^Gvs      , Re^Gvs      , Re^Gvs      , Re^Gvs      , Re^Gvs      , Re^Gvs      , Re          , Re          , Aa          , Aa          
Cea         , Aa          , Aa          , Aa          , Aa          , Aa          , Aa^Fpa      , Aa          , Aa          , Aa          , Aa          , Aa          , Re          , Re          , Re^Gvs      , Re^Gvs      , Re^Gvs      , Re^Gvs      , Rb          , Rb          , Gd^Fetd     , Re^Gvs      , Rrc         , Rrc         , Rrc         , Rb          , Aa          , Rb          , Rr          , Rr          , Rb          , Rb          , Rb          , Aa          , Re          , Re          , Re^Gvs      , Re^Gvs      , Re^Gvs      , Re^Gvs      , Re          , Re          , Aa          , Aa          , Aa          , Cea         
Aa          , Cea         , Cea         , Aa          , Aa          , Aa          , Aa          , Aa          , Ha          , Ha          , Ha          , Aa          , Aa          , Re          , Rb^Vhr      , Re          , Rb          , Rb          , Re^Gvs      , Re^Gvs      , Re^Gvs      , Re^Gvs      , Re^Gvs      , Rrc         , Rr          , Rb          , Ce          , Rb          , Rr          , Rb          , Aa          , Rb          , Rb          , Re          , Re          , Re^Gvs      , Re^Gvs      , Re^Gvs      , Re          , Re          , Re          , Re          , Aa          , Aa          , Cea         , Cea         
Aa          , Aa          , Cea         , Aa          , Aa          , Aa          , Aa          , Aa          , Aa          , Ha          , Ha          , Aa          , Aa          , Aa          , Rb          , Rb          , Rb          , Re^Gvs      , Re^Gvs      , Re^Gvs      , Re^Gvs      , Re^Gvs      , Re^Gvs      , Rr          , Rr          , Rb          , Rr          , Rr          , Rb          , Rb          , Aa          , Aa          , Aa          , Rb          , Re          , Re          , Re          , Re          , Aa          , Aa          , Aa          , Aa          , Aa          , Cea         , Cea         , Aa          
Aa          , Aa          , Aa          , Cea         , Cea         , Aa          , Aa          , Aa          , Aa          , Aa          , Aa          , Aa          , Rb          , Rb          , Ce          , Rb          , Rb          , Gs^Vh       , Re^Gvs      , Re^Gvs      , Re^Gvs      , Re^Gvs      , Re^Gvs      , Gs^Vh       , Rr          , Rr          , Rb          , Rb          , Aa          , Aa          , Aa^Fpa      , Aa^Fpa      , Aa          , Rb          , Rb          , Aa          , Aa          , Aa          , Aa^Fpa      , Aa          , Aa          , Aa          , Cea         , Cea         , Aa          , Aa          
Aa          , Aa          , Aa          , Aa          , Aa          , Rb          , Ce          , Aa          , Aa          , Rb          , Aa          , Aa          , Rb          , Aa          , Aa          , Rb          , Re^Gvs      , Re^Gvs      , Re          , Re^Gvs      , Re^Gvs      , Re^Gvs      , Re^Gvs      , Re^Gvs      , Rb          , Rr          , Rb          , Aa          , Gll^Fp      , Aa^Fpa      , Gll^Fp      , Aa^Fpa      , Aa          , Rb          , Rb          , Aa          , Aa          , Aa          , Aa          , Aa          , Aa          , Cea         , Aa          , Aa          , Aa          , Aa          
Aa          , Aa          , Aa          , Aa          , Aa          , Aa          , Aa          , Aa          , Chr         , Rb          , Rb          , Rb          , Aa          , Aa          , Gll^Fp      , Re          , Gll^Fp      , Re          , Re^Gvs      , Re^Gvs      , Re          , Re          , Rb          , Re          , Rb          , Rr          , Rr          , Gll^Fp      , Gll^Fp      , Gll^Fp      , Gll^Fp      , Aa^Fpa      , Aa          , Aa          , Rb          , Aa          , Aa          , Aa          , Cha         , Aa          , Cha         , Aa          , Aa          , Aa          , Aa          , Aa          
Aa          , Aa          , Aa          , Aa          , Rb          , Uu          , Rb          , Chr         , 5 Khr       , Rb          , Chr         , Aa          , Aa^Fpa      , Aa^Fpa      , Aa^Fpa      , Gll^Fp      , Gll^Fp      , Gll^Fp      , Gll^Fp      , Rb          , Rb          , Rb          , Gll^Fp      , Rb          , Rb          , Rb          , Rb          , Gll^Fp      , Gll^Fp      , Gll^Fp      , Gll^Fp      , Gll^Fp      , Rb          , Rb          , Re          , Rb          , Rb          , Aa          , Rb          , 3 Kha       , Aa          , Aa          , Aa          , Aa          , Aa          , Aa          
Aa          , Aa          , Aa          , Rb          , Aa          , Rb          , Rb          , Chr         , Rb          , Chr         , Rb          , Aa          , Aa          , Aa          , Aa          , Rb          , Rb          , Gll^Fp      , Gll^Fp      , Rb          , Gll^Fp      , Gll^Fp      , Gll^Fp      , Gll^Fp      , Gll^Fp      , Rb          , Rb          , Gll^Fp      , Gll^Fp      , Gll^Fp      , Gll^Fp      , Gs^Vh       , Rb          , Rb          , Re^Gvs      , Re          , Re          , Rb          , Cha         , Cha         , Cha         , Aa          , Aa          , Aa          , Aa          , Aa          
Aa          , Aa          , Aa          , Rb          , Aa          , Rb          , Rb          , Rb          , Uu          , Rb          , Uu          , Aa          , Aa          , Cea         , Cea         , Aa          , Aa          , Rb          , Rb          , Gll^Fp      , Rb          , Gll^Fp      , Gll^Fp      , Gll^Fp      , Aa^Fpa      , Rb          , Rb          , Gll^Fp      , Gll^Fp      , Gll^Fp      , Aa^Fpa      , Rb          , Re          , Re^Gvs      , Re^Gvs      , Re^Gvs      , Re          , Aa          , Aa          , Aa          , Aa          , Aa          , Aa          , Aa          , Aa          , Aa          
Aa          , Aa^Vca      , Aa          , Aa          , Aa          , Re^Vct      , Rb          , Rb          , Aa          , Aa          , Aa          , Aa          , Aa          , Aa          , Aa          , Cea         , Cea         , Aa          , Aa          , Aa          , Aa          , Aa^Fpa      , Aa          , Aa^Fpa      , Aa          , Rb          , Rb          , Aa          , Aa          , Aa^Fpa      , Aa          , Rb          , Re          , Re^Gvs      , Re^Gvs      , Re^Gvs      , Re          , Aa          , Aa          , Aa          , Aa          , Aa          , Aa          , Aa          , Aa          , Aa          
Aa^Fpa      , Aa          , Aa          , Aa          , Aa          , Aa          , Aa          , Aa          , Aa          , Aa          , Aa          , Aa          , Aa          , Aa          , Aa          , Aa          , Aa          , Cea         , Cea         , Aa          , Cea         , Aa          , Cea         , Aa          , Aa          , Rb          , Rb          , Aa          , Aa          , Aa          , Cea         , Rb          , Rb          , Re          , Re          , Re          , Aa          , Aa          , Cea         , Cea         , Aa          , Aa          , Aa          , Aa          , Aa          , Aa          
Aa^Fpa      , Aa^Fpa      , Aa          , Aa^Fpa      , Aa          , Aa          , Rb          , Aa          , Aa          , Aa          , Aa          , Aa          , Aa          , Aa          , Aa          , Aa          , Aa          , Aa          , Aa          , Cea         , Aa          , Cea         , Aa          , Aa          , Aa          , Cha         , Rb          , Rb          , Aa          , Cea         , Aa          , Cea         , Cea         , Aa          , Aa          , Aa          , Cea         , Cea         , Aa          , Aa          , Aa          , Aa          , Aa          , Aa          , Aa          , Aa          
Ha^Fpa      , Aa^Fpa      , Aa          , Aa          , Aa          , Rb          , Rb          , Aa          , Aa          , Aa^Fpa      , Aa^Fpa      , Aa          , Aa          , Aa          , Aa          , Aa          , Aa          , Aa          , Aa          , Aa          , Aa          , Aa          , Aa          , Aa          , Aa          , Aa          , Rb          , Rb          , Rb          , Aa          , Aa          , Aa          , Aa          , Cea         , Cea         , Cea         , Aa          , Aa          , Aa          , Aa          , Aa          , Aa          , Aa          , Aa          , Ha          , Aa          
Ha^Fpa      , Aa^Fpa      , Aa^Fpa      , Aa          , Rb          , Rb          , Rb          , Aa          , Aa          , Aa          , Aa^Fpa      , Aa^Fpa      , Aa          , Aa          , Aa          , Aa          , Aa          , Aa          , Aa          , Aa          , Aa          , Aa          , Aa          , Aa          , Aa          , Aa^Vha      , Aa          , Rb          , Rb          , Rb          , Rb          , Aa          , Aa          , Aa          , Aa          , Aa          , Aa          , Aa          , Aa          , Aa          , Aa          , Aa          , Ha          , Ha          , Ha          , Ha          
Ha^Fpa      , Aa^Fpa      , Aa^Fpa      , Aa          , Aa          , Rb          , Aa          , Aa          , Aa          , Aa          , Aa          , Aa          , Aa^Fpa      , Aa^Fpa      , Aa^Fpa      , Aa          , Aa          , Aa          , Aa^Fpa      , Aa^Fpa      , Aa          , Aa          , Aa          , Aa          , Aa          , Aa          , Aa          , Aa          , Aa          , Rb          , Rb          , Rb          , Rb          , Aa          , Aa          , Aa          , Aa          , Aa          , Aa          , Aa          , Aa          , Ha          , Ha          , Ha          , Ha          , Ha          
Ha^Fpa      , Aa^Fpa      , Aa^Fpa      , Aa          , Aa          , Aa          , Aa          , Aa          , Aa          , Aa          , Aa          , Aa          , Ha          , Ha^Fpa      , Ha          , Aa          , Aa          , Aa          , Aa^Fpa      , Aa^Fpa      , Aa          , Aa          , Aa          , Aa          , Aa          , Aa          , Aa          , Aa          , Aa          , Aa          , Aa          , Rb          , Rb          , Rb          , Aa          , Aa          , Aa          , Aa          , Aa          , Aa          , Aa          , Aa          , Aa          , Ha^Vhha     , Aa          , Ha          
Ha^Fpa      , Ha^Fpa      , Aa^Fpa      , Aa          , Aa          , Rb          , Rb          , Aa          , Aa          , Aa          , Ha          , Ha          , Ha          , Ha          , Ha          , Ha          , Aa          , Aa          , Aa          , Aa          , Aa          , Aa          , Aa^Vca      , Aa          , Aa          , Aa          , Aa          , Aa          , Aa          , Aa          , Aa          , Aa          , Re^Vct      , Rb          , Rb          , Aa          , Aa          , Aa          , Aa          , Aa          , Aa          , Aa          , Aa          , Aa          , Aa          , Aa          
Ha^Fpa      , Ha^Fpa      , Aa^Fpa      , Aa          , Aa          , Aa          , Rb          , Aa          , Aa          , Aa          , Aa          , Ha          , Aa          , Ha          , Aa          , Aa          , Aa          , Aa          , Aa          , Aa          , Aa          , Aa          , Aa          , Aa          , Aa          , Aa          , Aa          , Aa^Fpa      , Aa^Fpa      , Aa          , Aa          , Aa          , Rb          , Rb          , Rb          , Aa          , Cea         , Aa          , Aa          , Aa          , Aa          , Aa          , Aa          , Aa          , Aa^Fpa      , Aa^Fpa      
Ha^Fpa      , Ha^Fpa      , Aa^Fpa      , Aa^Fpa      , Aa^Fpa      , Aa          , Rb          , Aa          , Aa          , Aa          , Aa          , Aa          , Aa          , Aa          , Aa          , Aa          , Aa          , Aa          , Aa          , Aa          , Aa          , Aa          , Aa          , Aa          , Aa          , Aa          , Aa          , Aa^Fpa      , Aa          , Aa          , Aa          , Aa          , Rb          , Rb          , Rb          , Cea         , 1 Kea       , Cea         , Aa          , Aa          , Aa          , Aa          , Aa          , Aa^Fpa      , Aa^Fpa      , Aa^Fpa      
Aa^Fpa      , Aa^Fpa      , Aa^Fpa      , Aa^Fpa      , Aa^Fpa      , Aa^Fpa      , Rb          , Aa          , Aa^Fpa      , Aa          , Aa          , Aa          , Aa          , Aa          , Aa          , Aa          , Aa          , Aa          , Aa          , Aa          , Aa          , Aa          , Ha          , Aa          , Ha          , Aa          , Aa          , Aa          , Aa          , Aa          , Aa          , Aa          , Rb          , Rb          , Aa          , Cea         , Cea         , Cea         , Aa          , Aa          , Aa          , Aa          , Aa^Fpa      , Aa^Fpa      , Aa^Fpa      , Aa^Fpa      
Aa^Fpa      , Aa^Fpa      , Aa^Fpa      , Aa^Fpa      , Aa^Fpa      , Aa^Fpa      , Rb          , Aa^Fpa      , Aa^Fpa      , Aa^Fpa      , Aa^Fpa      , Aa^Fpa      , Aa^Fpa      , Aa          , Aa          , Aa          , Aa          , Aa          , Aa          , Aa          , Ha          , Ha          , Ha          , Ha          , Ha          , Ha          , Ha          , Aa          , Aa          , Aa          , Aa          , Aa          , Rb          , Rb          , Aa          , Aa          , Rb          , Rb          , Aa          , Aa          , Aa          , Aa^Fpa      , Aa^Fpa      , Aa^Fpa      , Aa^Fpa      , Aa^Fpa      
