border_size=1
usage=map

Ms^Xm       , Ms^Xm       , Ms^Xm       , Ha          , Ha          , Aa          , Ai          , Ww          , Ai          , Aa          , Aa          , Ha          , Ha          , Ha          , Rb          , Rb          , Rb          , Aa^Fpa      , Ha          , Ha          , Ha          , Ha          , Ha          , Ha          , Ha          , Ms^Xm       , Ms^Xm       
Ms^Xm       , Ms^Xm       , Ha          , Ha          , Ha          , Aa          , Ai          , Ai          , Ai          , Aa          , Aa          , Aa^Fpa      , Ha          , Ha          , Ce          , Ce          , Ce          , Aa^Fpa      , Ha          , Ha          , Aa^Fpa      , Ha          , Ha          , Ha          , Ha          , Ms^Xm       , Ms^Xm       
Ms^Xm       , Ha          , Ha          , Ha          , Ha          , Aa          , Ww          , Ai          , Ai          , Aa          , Aa^Fpa      , Aa^Fpa      , Aa^Fpa      , Ha          , Ce          , 1 Ke        , Ce          , Aa^Fpa      , Aa^Fpa      , Aa^Fpa      , Aa^Fpa      , Ha          , Ha          , Ha          , Ha          , Ms^Xm       , Ms^Xm       
Ms^Xm       , Ha          , Ha          , Ha          , Ha          , Aa          , Ai          , Ai          , Ai          , Aa^Fpa      , Aa^Fpa      , Aa^Fpa      , Aa^Fpa      , Aa          , Rb          , Ce          , Rb          , Rb          , Aa          , Aa^Fpa      , Aa^Fpa      , Aa^Fpa      , Ha          , Ha          , Ha          , Ha^Vhha     , Ms^Xm       
Ms^Xm       , Ha          , Ha          , Ha          , Aa          , Aa          , Ai          , Ai          , Ai          , Aa^Fpa      , Aa^Fpa      , Aa^Fpa      , Aa^Fpa      , Aa          , Rb          , Rb          , Rb          , Rb          , Aa          , Aa^Fpa      , Aa^Fpa      , Aa^Fpa      , Aa^Fpa      , Ha          , Ha          , Ha          , Ms          
Ha          , Ha          , Ha          , Ha          , Ha          , Aa^Vha      , Ai          , Ai          , Ai          , Aa^Fpa      , Aa^Fpa      , Aa^Fpa      , Aa          , Aa          , Rb          , Rb          , Rb^Es       , Rb          , Aa^Vha      , Aa          , Aa^Fpa      , Aa^Fpa      , Aa^Fpa      , Ha          , Ha          , Ha          , Ms          
Ha          , Ha          , Ha          , Ha          , Ha          , Ha          , Ai          , Ww          , Ai          , Ai          , Ai          , Aa^Fpa      , Aa          , Aa          , Aa          , Rb          , Rb          , Rb          , Rb          , Aa          , Aa          , Aa^Fpa      , Aa^Fpa      , Aa^Fpa      , Ha          , Ha          , Ms          
Ha          , Ha          , Ha          , Ha          , Ha          , Ha          , Ha          , Ai          , Aa^Fpa      , Ai          , Ai          , Ai          , Ai          , Aa          , Aa          , Rb          , Rb          , Rb          , Rb          , Aa          , Aa          , Aa^Fpa      , Aa^Fpa      , Aa^Fpa      , Aa^Fpa      , Ha          , Ms          
Ha          , Ha          , Ha          , Ha          , Ha          , Ha          , Aa^Fpa      , Aa^Fpa      , Aa^Fpa      , Aa^Fpa      , Aa^Fpa      , Ai          , Ai          , Aa          , Aa          , Aa          , Rb          , Rb          , Rb          , Aa          , Aa          , Aa          , Aa^Fpa      , Aa^Fpa      , Aa^Fpa      , Aa^Fpa      , Ms          
Ha          , Ha          , Ha          , Ha          , Ha          , Aa^Fpa      , Aa^Fpa      , Aa^Fpa      , Aa^Fpa      , Aa^Fpa      , Aa          , Ww          , Ai          , Aa          , Aa          , Aa          , Aa          , Rb          , Rb^Es       , Rb          , Rb          , Aa          , Aa          , Aa^Fpa      , Aa^Fpa      , Aa^Fpa      , Ms          
Ha          , Ha          , Aa^Fpa      , Ha^Vhha     , Aa^Fpa      , Aa^Fpa      , Aa^Fpa      , Aa^Fpa      , Aa^Fpa      , Aa^Fpa      , Aa          , Ai          , Ai          , Ai          , Aa          , Aa          , Aa          , Rb          , Rb          , Rb          , Rb          , Rb          , Rb          , Aa          , Aa          , Aa^Fpa      , Ms          
Aa^Fpa      , Aa^Fpa      , Aa^Fpa      , Aa^Fpa      , Aa^Fpa      , Aa^Fpa      , Aa^Fpa      , Aa^Fpa      , Aa          , Aa          , Aa          , Ai          , Ai          , Ai          , Ww          , Aa          , Aa          , Aa          , Aa          , Rb          , Rb          , Rb          , Rb          , Rb          , Aa          , Aa^Fpa      , Ms          
Aa^Fpa      , Aa^Fpa      , Aa^Fpa      , Aa^Fpa      , Aa^Fpa      , Aa^Fpa      , Aa^Fpa      , Aa          , Aa          , Aa          , Aa^Fpa      , Aa^Fpa      , Aa^Fpa      , Ai          , Ai          , Ww          , Ww          , Aa          , Aa          , Aa          , Aa          , Rb          , Rb^Es       , Rb          , Aa          , Aa^Fpa      , Mm          
Aa^Fpa      , Aa^Fpa      , Aa^Fpa      , Aa^Fpa      , Aa^Fpa      , Aa^Fpa      , Aa          , Aa          , Aa          , Aa          , Aa^Fpa      , Aa^Fpa      , Aa^Fpa      , Aa          , Aa          , Ai          , Ai          , Ai          , Ww          , Aa          , Aa          , Rb          , Rb          , Rb          , Aa          , Aa^Fpa      , Mm          
Aa^Fpa      , Aa^Fpa      , Aa^Fpa      , Aa^Fpa      , Aa^Fpa      , Aa^Fpa      , Aa          , Aa          , Aa          , Aa          , Gg          , Aa^Fpa      , Aa          , Aa          , Aa          , Aa          , Aa          , Ai          , Ww          , Ww          , Ai          , Rb          , Rb          , Rb          , Gg          , Aa^Fpa      , Mm          
Aa^Fpa      , Aa^Fpa      , Aa^Fpa      , Aa^Fpa      , Gs^Fp       , Gs^Fp       , Gs^Fp       , Gg          , Gg          , Gg          , Gg          , Gg          , Gg          , Gg          , Gg          , Aa^Vha      , Gg          , Gg          , Gg          , Ww          , Ww          , Rb          , Rb          , Re          , Chr         , Gs^Fp       , Mm          
Aa^Fpa      , Aa^Fpa      , Gs^Fp       , Gs^Fp       , Gs^Fp       , Gs^Fp       , Gg^Vh       , Gs^Fp       , Gs^Fp       , Gg          , Gs^Fp       , Gg          , Gg          , Gg          , Gg          , Gg          , Gg          , Gg          , Gs^Fp       , Ww          , Ww          , Re          , Re          , Re          , Chr         , 3 Khr       , Mm          
Gs^Fp       , Gs^Fp       , Gs^Fp       , Gs^Fp       , Gg          , Gg          , Gg          , Gg          , Gg          , Gs^Fp       , Gg          , Gs^Fp       , Gg          , Gg          , Gg^Es       , Gg          , Gg          , Gs^Fp       , Gg          , Ww          , Ww^Bw/      , Re          , Re          , Re          , Gg          , Chr         , Gs^Fp       
Gg          , Gs^Fp       , Gg          , Gg          , Gg          , Gg          , Gg          , Gg          , Gg          , Gg          , Gg          , Gg          , Gg          , Gg          , Gg          , Gg          , Gg          , Gg^Vh       , Re          , Ww^Bw/      , Ww          , Chr         , Re          , Re          , Gs^Fp       , Gs^Fp       , Gs^Fp       
Gg          , Gg          , Gg          , Rp          , Chr         , Rp          , Gg          , Gg          , Gg          , Chr         , Gg          , Gg          , Gg          , Gg          , Gg          , Gg          , Re          , Re          , Re          , Ww          , Ww          , Re          , Re          , Re          , Gg          , Gg          , Gs^Fp       
Gg          , Gg          , Rp          , Chr         , 2 Khr       , Chr         , Rp          , Gd          , Gg          , Chr         , Gg          , Gg          , Re          , Re          , Re          , Re          , Re          , Re          , Chr         , Ww          , Ww^Bw/      , Re          , Gg          , Gg^Es       , Gg          , Hh          , Mm          
Gg          , Gg          , Gg          , Chr         , Chr         , Chr         , Rp          , Gg          , Gg          , Gg          , Re          , Re          , Re          , Re          , Re          , Re          , Re          , Re          , Re          , Ww^Bw/      , Ww          , Ww          , Gg          , Gg          , Gg^Vh       , Hh          , Mm          
Gg          , Gg^Es       , Gg          , Rp          , Gg          , Rp          , Gg          , Rp          , Rp          , Rp^Vh       , Re          , Re          , Re          , Re          , Re          , Re          , Gg          , Gg          , Gg          , Gg          , Ww          , Ww          , Gg          , Gg          , Gs^Fp       , Gs^Fp       , Mm          
Gg          , Gg          , Gg          , Gg          , Gg          , Gd          , Gg          , Gd          , Rr          , Rp          , Re          , Re          , Re          , Re          , Gg          , Gg          , Gg          , Gg          , Gg          , Gg^Es       , Ww          , Ww          , Gd          , Gs^Fp       , Gs^Fp       , Gs^Fp       , Mm          
Gg          , Gg          , Gg          , Chr         , Gg          , Chr         , Gg          , Gg          , Rp          , Rp          , Re          , Re          , Gg          , Gg          , Gg          , Gg^Es       , Gll         , Gg          , Gll         , Gg          , Ww          , Ww          , Ds          , Gd          , Gg          , Hh          , Mm          
Gs^Fp       , Gs^Fp       , Gs^Fp       , Gg          , Gs^Fp       , Gg          , Gg          , Gg          , Re          , Rp          , Re          , Gg^Vh       , Gg          , Gll         , Gd          , Gg          , Gg          , Gd          , Ds          , Ds          , Ww          , Ww          , Ds          , Gd          , Mm          , Mm          , Mm          
Gs^Fp       , Gs^Fp       , Gs^Fp       , Gs^Fp       , Gs^Fp       , Gs^Fp       , Gd^Fp       , Gs^Fp       , Re          , Re          , Re          , Gg          , Gs^Fp       , Gg          , Gg          , Gg          , Gg          , Gd^Vh       , Ds          , Ww          , Ww          , Ww          , Mm          , Mm          , Mm          , Mm          , Mm          
Gs^Fp       , Gs^Fp       , Gs^Fp       , Gs^Fp       , Gs^Fp       , Gg          , Gd          , Gg          , Re          , Re          , Re          , Gs^Fp       , Gg          , Gs^Fp       , Gs^Fp       , Gd          , Gg          , Ds          , Ww          , Ww          , Ww          , Ds          , Mm          , Mm          , Mm          , Mm          , Mm          
Gs^Fp       , Gs^Fp       , Gg          , Gg          , Gg^Fet      , Gg          , Gd          , Gd          , Re          , Re          , Re          , Gs^Fp       , Gs^Fp       , Gs^Fp       , Gs^Fp       , Gs^Fp       , Gs^Fp       , Ds          , Ww          , Ww          , Ww          , Ds          , Mm          , Mm          , Mm          , Mm          , Mm          
Gs^Fp       , Gg          , Gg          , Gg          , Gs^Fp       , Gg          , Gg          , Gg          , Re          , Re          , Re          , Gg          , Gs^Fp       , Gs^Fp       , Gd          , Gs^Fp       , Gs^Fp       , Ds          , Ds          , Ww          , Ww          , Ds          , Ds          , Mm          , Hh          , Mm          , Mm          
Gs^Fp       , Gg^Ve       , Gg^Fet      , Gg          , Gd          , Gs^Fp       , Gs^Fp       , Gs^Fp       , Re          , Re          , Re          , Gs^Fp       , Gg          , Gs^Fp       , Gg^Ve       , Gd          , Gs^Fp       , Gg          , Ds          , Ww          , Ww          , Ww          , Ds          , Gd          , Hh          , Hh          , Mm          
Gs^Fp       , Gs^Fp       , Gs^Fp       , Gd          , Gs^Fp       , Gd          , Gs^Fp       , Gs^Fp       , Re          , Re          , Re          , Re          , Re          , Gg          , Gs^Fp       , Gg^Fet      , Gs^Fp       , Gs^Fp       , Gs^Fp       , Ds          , Ww          , Ww          , Ds          , Gd          , Hh          , Mm          , Mm          
Gs^Fp       , Gs^Fp       , Gs^Fp       , Gs^Fp       , Gs^Fp       , Gs^Fp       , Gs^Fp       , Gs^Fp       , Gs^Fp       , Re          , Re          , Re          , Re          , Re          , Gs^Fp       , Gs^Fp       , Gs^Fp       , Gs^Fp       , Gs^Fp       , Ds          , Ww          , Ww          , Ds          , Gd          , Hh          , Mm          , Mm          
Gs^Fp       , Cv          , Gs^Fp       , Gs^Fp       , Gs^Fp       , Cv          , Gs^Fp       , Gs^Fp       , Gs^Fp       , Cv          , Re          , Re          , Re          , Cv          , Re          , Gs^Fp       , Gs^Fp       , Cv          , Gd          , Ds          , Ww          , Ww          , Ds          , Gd          , Hh          , Hh          , Mm          
Gs^Fp       , Gs^Fp       , Gs^Fp       , Gs^Fp       , Gs^Fp       , Gs^Fp       , Gs^Fp       , Gs^Fp       , Gs^Fp       , Gs^Fp       , Gs^Fp       , Re          , Re          , Re          , Re          , Re          , Gs^Fp       , Gs^Fp       , Gs          , Ds          , Ww          , Ww          , Ds          , Gd          , Gs^Fp       , Gs^Fp       , Mm          
Gs^Fp       , Gs^Fp       , Gs^Fp       , Gs^Fp       , Gs^Fp       , Gs^Fp       , Gg^Fet      , Gs^Fp       , Gs^Fp       , Gs^Fp       , Gs^Fp       , Gs^Fp       , Gs^Fp       , Re          , Re          , Re          , Re          , Gs^Fp       , Gd          , Ds          , Ww          , Ww          , Ds          , Gd          , Gs          , Gs^Fp       , Mm          
Gs^Fp       , Gg^Fet      , Gs^Fp       , Gs^Fp       , Gs^Fp       , Gs^Fp       , Gs^Fp       , Gs^Fp       , Gs^Fp       , Gs^Fp       , Gg^Fet      , Gs^Fp       , Gs^Fp       , Gg^Ve       , Re          , Re          , Re          , Gs^Fp       , Gd          , Ds          , Ww          , Ww          , Ww          , Ds          , Gs^Ft       , Gs^Fp       , Mm          
Gs^Fp       , Gs^Fp       , Gs^Fp       , Gs^Fp       , Gs^Fp       , Gs^Fp       , Gs^Fp       , Gs^Fp       , Gs^Fp       , Gs^Fp       , Gs^Fp       , Gs^Fp       , Gs^Fp       , Gs^Fp       , Re          , Re          , Re          , Gs^Fp       , Gs          , Ds          , Ww          , Ww          , Ww          , Ds          , Gs          , Gs^Fp       , Mm          
Gs^Fp       , Gs^Fp       , Gs^Fp       , Gs^Fp       , Cv          , Cv          , Cv          , Gs^Fp       , Gs^Fp       , Gs^Fp       , Gs^Fp       , Gs^Fp       , Gs^Fp       , Gs^Fp       , Re          , Re          , Re          , Gs^Fp       , Gs^Ft       , Ds          , Ww          , Ww          , Ww          , Ds          , Gd          , Hh          , Mm          
Gs^Fp       , Gs^Fp       , Gs^Fp       , Gs^Fp       , Gs^Fp       , 4 Kv        , Gd          , Gd          , Gd          , Gs^Fp       , Gs^Fp       , Gs^Fp       , Gs^Fp       , Gs^Fp       , Re          , Re          , Re          , Gs^Fp       , Gs^Fp       , Gd          , Gs^Ft       , Ww          , Ww          , Ds          , Gs          , Hh          , Mm          
Gs^Fp       , Gs^Fp       , Gg^Fet      , Gs^Fp       , Gs^Fp       , Gs^Fp       , Gg^Ve       , Gd          , Gd          , Gg^Ve       , Gs^Fp       , Gs^Ft       , Gs^Fp       , Gs^Fp       , Re          , Re          , Re          , Gs^Fp       , Gs^Fp       , Gs          , Ds          , Ww          , Ww          , Ds          , Gs^Ft       , Hh          , Mm          
Gs^Ft       , Gs^Fp       , Gs^Fp       , Gs^Fp       , Gs^Fp       , Gs^Fp       , Gs^Fp       , Gs^Fp       , Gs^Fp       , Gs^Fp       , Gs^Fp       , Gs^Fp       , Gs^Fp       , Gs^Fp       , Re          , Re          , Re          , Gg^Fet      , Gs^Fp       , Gs          , Ds          , Ww          , Ww          , Ds          , Gs          , Hh          , Mm          
