border_size=1
usage=map

Zdyd        , Zdyd        , Zdyd        , Zdyd        , Zdyd        , Zdyd        , Zdyd        , Zdyd        , Zdyd        , Zdyd        , Zdyd        , Zdyd        , Zdyd        , Zdyd        , Zdyd        , Zdyd        , Zdyd        , Zdyd        , Zdyd        , Zdyd        , Zdyd        , Zdyd        , Zdyd        , Zdyd        , Zdyd        , Zdyd        , Zdyd        , Zdyd        , Zdyd        , Zdyd        , Zdyd        , Zdyd        , Zdyd        , Zdyd        , Zdyd        , Zdyd        , Zdyd        , Zdyd        , Zdyd        , Zdyd        , Zdyd        , Zdyd        
Zdyd        , Zdyd        , Zdyd        , Zdyd        , Zdyd        , Zdyd        , Zdyd        , Zdyd        , Zdyd        , Zdyd        , Zdyd        , Zdyd        , Zdyd        , Zdyd        , Zdyd        , Zdyd        , Zdyd        , Zdyd        , Zdyd        , Zdyd        , Zdyd        , Zdyd        , Zdyd        , Zdyd        , Zdyd        , Zdyd        , Zdyd        , Zdyd        , Zdyd        , Zdyd        , Zdyd        , Zdyd        , Zdyd        , Zdyd        , Zdyd        , Zdyd        , Zdyd        , Zdyd        , Zdyd        , Zdyd        , Zdyd        , Zdyd        
Zdyd        , Zdyd        , Zdyd        , Zdyd        , Zdyd        , Zdyd        , Zdyd        , Zdyd        , Zdyd        , Zdyd        , Zdyd        , Zdyd        , Zdyd        , Zdyd        , Zdyd        , Zdyd        , Zdyd        , Zdyd        , Ms^Xm       , Ms^Xm       , Ms          , Zdyd        , Zdyd        , Zdyd        , Ms          , Zdyd        , Ms          , Zdyd        , Ms          , Zdyd        , Ms          , Zdyd        , Zdyd        , Zdyd        , Zdyd        , Zdyd        , Zdyd        , Zdyd        , Zdyd        , Zdyd        , Zdyd        , Zdyd        
Zdyd        , Zdyd        , Zdyd        , Zdyd        , Zdyd        , Zdyd        , Zdyd        , Zdyd        , Zdyd        , Zdyd        , Zdyd        , Zdyd        , Zdyd        , Zdyd        , Zdyd        , Zdyd        , Ms          , Ms          , Cay         , Ms          , Cay         , Cay         , Cay         , Ms          , Cay         , Ms          , Cay         , Cay         , Cay         , Cay         , Cay         , Cay         , Cay         , Zdyd        , Zdyd        , Zdyd        , Zdyd        , Zdyd        , Zdyd        , Zdyd        , Zdyd        , Zdyd        
Zdyd        , Zdyd        , Zdyd        , Zdyd        , Zdyd        , Zdyd        , Zdyd        , Zdyd        , Zdyd        , Zdyd        , Zdyd        , Zdyd        , Zdyd        , Zdyd        , Ms          , Ms          , Cay         , Cay         , Cay^Ytwt    , Cay         , Cay         , Cay         , Cay         , Cay         , Cay         , Cay         , Cay         , Cay         , Cay         , Cay         , Cay         , Cay^Ytot    , Cay         , Cay         , Cay         , Zdyd        , Zdyd        , Zdyd        , Zdyd        , Zdyd        , Zdyd        , Zdyd        
Zdyd        , Zdyd        , Zdyd        , Zdyd        , Zdyd        , Zdyd        , Zdyd        , Zdyd        , Zdyd        , Zdyd        , Ms          , Ms          , Cay         , Ms          , Cay         , Cay         , Cay         , Cay         , Cay         , Cay         , Cay         , Cay         , Cay         , Cay         , Rr          , Rr          , Rr          , Cay         , Rp          , Cay         , Rp          , Cay         , Cay         , Cay         , Cay         , Ms          , Ms          , Zdyd        , Zdyd        , Zdyd        , Zdyd        , Zdyd        
Zdyd        , Zdyd        , Zdyd        , Zdyd        , Ms          , Zdyd        , Zdyd        , Zdyd        , Ms^Xm       , Ms          , Cay         , Cay         , Cay         , Cay         , Cay         , Cay         , Cay         , Cay         , Rp          , Cay         , Rr          , Rp          , Rr          , Rr          , Rrc         , Rrc         , Rrc         , Rr          , Rr          , Rp          , Rp          , Rp          , Rp          , Cay         , Cay         , Cay         , Cay         , Ms          , Ms          , Zdyd        , Zdyd        , Zdyd        
Ms          , Zdyd        , Ms          , Ms          , Ha          , Ms          , Ms^Xm       , Ms^Xm       , Ms          , Ms          , Cay         , Cay         , Rp          , Cay         , Rr          , Rr          , Rr          , Rr          , Rr          , Rr          , Cay         , Cay         , Cay         , Rr          , Rrc         , Rrc         , Rrc         , Rrc         , Rrc         , Rr          , Rp          , Re          , Re          , Rp          , Cay         , Cay         , Cay         , Ha          , Ms          , Ms          , Zdyd        , Zdyd        
Ms          , Ms          , Ha          , Ha          , Ha          , Ha          , Ms^Xm       , Ms^Xm       , Ms          , Cay         , Cay         , Cay         , Rp          , Rr          , Rrc         , Rrc         , Rr          , Rr          , Rp          , Rp          , Cay         , Cay^Yalt    , Cay         , Rr          , Rr          , Rr          , Rr          , Rrc         , Rr          , Rr          , Rp          , Re          , Rp          , Rp          , Cay         , Cay         , Cay         , Ha          , Ha          , Ms          , Ms          , Zdyd        
Ms          , Ms          , Ms          , Ha          , Ha          , Ha^Fpa      , Ha^Fpa      , Ms^Xm       , Ms          , Cay         , Cay         , Cay         , Cay         , Rr          , Rr          , Rr          , Rr          , Rr          , Ymnt        , Rp          , Rp          , Cay         , Rr          , Rr          , Rr          , Rr          , Cay         , Rr          , Rr          , Rp          , Rp          , Rp          , Rr          , Rr          , Cay         , Cay         , Cay         , Ha          , Ha          , Ms          , Ms          , Ms          
Ms          , Ms          , Ms          , Ha          , Ha          , Ha^Fpa      , Ha^Fpa      , Ha^Fpa      , Ha^Fpa      , Cay         , Cay         , Cay         , Cay         , Cay         , Cay         , Cay         , Cay         , Rr          , Cay         , Rr          , Rrc         , Rr          , Rrc         , Rr          , Rr          , Cay         , 2 Kay       , Cay         , Re^Vct      , Rr          , Rr          , Rp          , Rr          , Rp          , Cay         , Cay         , Cay         , Ha          , Ha          , Ha          , Ms          , Ms          
Ms          , Ms          , Ms          , Ms          , Ms          , Ha          , Ha^Fpa      , Ha^Fpa      , Ha^Fpa      , Ha          , Ha          , Cay         , Cay         , Cay         , Cay         , Cay         , Cay         , Cay         , Cay         , Cay         , Cay         , Cay         , Cay         , Cay         , Rr          , Cay         , Cay         , Cay         , Rr          , Rr          , Rp          , Rp          , Cay         , Cay         , Cay         , Cay         , Cay         , Ha          , Ha          , Ha          , Ms          , Ms          
Ms          , Ha          , Ms          , Ms          , Ms          , Ha^Fpa      , Ha          , Ha^Fpa      , Ha          , Ha          , Ha          , Ha          , Ha          , Ha          , Ha          , Cay         , Ha          , Cay         , Cay         , Cay         , Cay         , Cay^Ytot    , Cay         , Cay         , Rr          , Rp          , Rr          , Rr          , Rp          , Rr          , Cay         , Cay         , Cay         , Cay         , Cay         , Cay         , Ha          , Ha          , Ha          , Ha          , Ms          , Ha          
Ms          , Ha          , Ha          , Ms          , Ms          , Ha          , Ha          , Ha          , Ha          , Ha          , Ha          , Ha          , Ha          , Ha          , Ha          , Ha          , Ha          , Ha          , Ha          , Cay         , Ha          , Cay         , Rrc         , Rr          , Rrc         , Rr          , Cay         , Cay         , Cay         , Cay         , Cay         , Cay         , Cay         , Cay         , Cay         , Cay         , Ha          , Ha          , Ms          , Ms          , Ms          , Ms          
Ms          , Ha          , Ha          , Ms          , Ms          , Ha          , Ha          , Ha          , Ha          , Ha          , Ha          , Ha          , Ha          , Ha          , Ha          , Ms          , Ms          , Ha          , Ha          , Ha          , Ha          , Ha          , Rrc         , Rrc         , Rrc         , Rrc         , Cay         , Cay^Ytwt    , Cay         , Cay         , Cay         , Cay         , Ha          , Ha          , Ha          , Ha          , Ha          , Ms          , Ms          , Ms          , Ms          , Ms          
Mm^Xm       , Ha          , Ha          , Ha          , Rb          , Ha          , Aa^Fpa      , Ha          , Ha          , Ha          , Ha          , Ha          , Aa^Fpa      , Ha          , Ha          , Ms          , Ms          , Ms          , Ms          , Ha          , Ha          , Ha          , Rrc         , Rrc         , Rrc         , Ha          , Ha          , Cay         , Cay         , Cay         , Ha          , Ha          , Ha          , Ha          , Ha          , Ha          , Ms          , Ms          , Ms          , Ms          , Ms^Xm       , Ms^Xm       
Mm^Xm       , Mm^Xm       , Rb          , Rb          , Aa^Fpa      , Aa^Fpa      , Aa^Fpa      , Aa^Fpa      , Ms^Xm       , Ms^Xm       , Ms^Xm       , Aa^Fpa      , Aa^Fpa      , Aa^Fpa      , Aa^Fpa      , Ha          , Ha          , Ms          , Ha          , Ha          , Aa^Fpa      , Aa^Fpa      , Rr          , Rr          , Re^Vct      , Ha          , Ha          , Ha          , Ha          , Ha          , Ha          , Ha          , Ha          , Ha          , Ha^Fpa      , Ms          , Ms          , Ms          , Ms          , Ms^Xm       , Ms^Xm       , Ms^Xm       
Rb          , Rb          , Rb          , Ha          , Aa^Fpa      , Aa^Fpa      , Aa^Fpa      , Ms^Xm       , Ms^Xm       , Ms^Xm       , Ms^Xm       , Aa^Fpa      , Aa^Fpa      , Aa^Fpa      , Aa^Fpa      , Aa^Fpa      , Aa^Fpa      , Ha          , Ha          , Aa^Fpa      , Aa^Fpa      , Aa^Fpa      , Rr          , Rp          , Aa^Fpa      , Ha          , Ha          , Ha          , Aa^Fpa      , Aa^Fpa      , Ha^Fpa      , Aa^Fpa      , Ha^Fpa      , Ha^Fpa      , Ha^Fpa      , Ha^Fpa      , Ha^Fpa      , Ms          , Ms          , Ms          , Ms          , Ms          
Rb          , Rb          , Rb          , Ha          , Ha          , Aa^Fpa      , Aa^Fpa      , Ms^Xm       , Aa^Fpa      , Ms^Xm       , Ms          , Ms          , Aa^Fpa      , Aa^Fpa      , Aa^Fpa      , Aa^Fpa      , Aa^Fpa      , Ha          , Ha          , Aa^Fpa      , Rb          , Aa^Fpa      , Rr          , Rp          , Rb          , Aa^Fpa      , Ha          , Aa^Fpa      , Ha^Fpa      , Ha^Fpa      , Ha^Fpa      , Ha^Fpa      , Ha^Fpa      , Ha^Fpa      , Ha^Fpa      , Ha^Fpa      , Ha^Fpa      , Ha^Fpa      , Ms          , Ms          , Ms          , Ms          
Ms^Xm       , Ha          , Ha          , Rb          , Ha          , Ha          , Ha          , Aa^Fpa      , Aa^Fpa      , Ms          , Ms          , Ms          , Aa^Fpa      , Ha          , Rb          , Aa^Fpa      , Rb          , Ha^Vhha     , Rb          , Rb          , Rb          , Rb          , Rb          , Rb          , Rb          , Aa^Fpa      , Ha          , Aa^Fpa      , Ha^Fpa      , Ha^Fpa      , Ha^Fpa      , Ha^Fpa      , Ha^Fpa      , Ha^Fpa      , Aa^Fpa      , Ha^Fpa      , Ms          , Ms          , Ms          , Ms          , Ms          , Ms          
Ms^Xm       , Ms^Xm       , Ms          , Ha          , Ha          , Ha          , Ha          , Ha          , Rb          , Aa^Fpa      , Aa^Fpa      , Aa^Fpa      , Rb          , Rb          , Rb          , Rb          , Rb          , Rb          , Rb          , Rb          , Rb          , Rb          , Rb          , Rb          , Rb          , Rb          , Rb          , Ha          , Ha          , Ha          , Ms          , Ms          , Ms          , Ha^Fpa      , Ms          , Ms          , Ms          , Ms          , Ms          , Ms          , Ms          , Ms          
Ms^Xm       , Ms          , Ms          , Ms          , Ha          , Ha          , Rb          , Rb          , Rb          , Rb          , Rb          , Rb          , Rb          , Rb          , Rb          , Rb          , Rb          , Rb          , Rb          , Rb          , Rb          , Rb          , Cay         , Rb          , Rb          , Rb          , Rb          , Rb          , Ha          , Ms          , Ms          , Ms          , Ms^Xm       , Ms          , Ms^Xm       , Ms^Xm       , Ms^Xm       , Ms          , Ms          , Ms          , Ha          , Ms          
Ms^Xm       , Ms          , Ms          , Ms          , Ha          , Rb          , Rb          , Rb          , Rb          , Rb          , Rb          , Rb          , Rb          , Rb          , Ha          , Rb          , Ha          , Rb          , Ha          , Rb          , Re^Vct      , Cay         , Cay         , Cay         , Aa^Fpa      , Rb          , Rb          , Rb          , Ha          , Ms          , Ms          , Ms          , Ms^Xm       , Ms^Xm       , Ms^Xm       , Ms^Xm       , Ms^Xm       , Ms          , Ha          , Ha          , Ha          , Ha          
Ms^Xm       , Ms^Xm       , Ms          , Ms          , Aa^Fpa      , Rb          , Rb          , Rb          , Rb          , Rb          , Aa^Fpa      , Aa^Fpa      , Ha          , Aa^Fpa      , Ha          , Ha          , Ha          , Ha          , Ha          , Ha          , Ha          , Cay         , Cay         , Cay         , Aa^Fpa      , Rb          , Rb          , Rb          , Ha          , Ms          , Ms          , Ms^Xm       , Ms^Xm       , Ms^Xm       , Ms^Xm       , Ms^Xm       , Ms          , Ha          , Ha^Fpa      , Ha          , Ha          , Ha          
Ms^Xm       , Ms          , Ms          , Ms          , Ms          , Rb          , Rb          , Rb          , Ha          , Aa^Fpa      , Aa^Fpa      , Aa^Fpa      , Aa^Fpa      , Aa^Fpa      , Ha^Fpa      , Ha          , Ha          , Ha          , Ms          , Ha^Fpa      , Ha^Fpa      , Ha^Fpa      , Ha          , Ha          , Rb          , Rb          , Rb          , Rb          , Ha          , Ms          , Ms          , Ms^Xm       , Ms^Xm       , Ms^Xm       , Ms^Xm       , Ms          , Ms          , Ha^Fpa      , Ha^Fpa      , Ha^Fpa      , Ha^Fpa      , Ha          
Ms^Xm       , Ms^Xm       , Ms          , Ms          , Ms          , Rb          , Rb          , Rb          , Ha          , Aa^Fpa      , Aa^Fpa      , Aa^Fpa      , Ha^Fpa      , Ha^Fpa      , Ha^Fpa      , Ha^Fpa      , Ms^Xm       , Ms          , Ms          , Ms          , Ms          , Ha          , Ha          , Aa^Fpa      , Rb          , Rb          , Rb          , Ha          , Ms          , Ms          , Ms          , Ms^Xm       , Ms          , Ms^Xm       , Ms          , Ms          , Ha          , Ha^Fpa      , Ha^Fpa      , Ha^Fpa      , Aa^Fpa      , Aa^Fpa      
Ms^Xm       , Ms          , Aa^Fpa      , Ms          , Ha          , Rb          , Rb          , Rb          , Rb          , Ha          , Ha          , Aa^Fpa      , Ha^Fpa      , Ha^Fpa      , Ms^Xm       , Ms^Xm       , Ms^Xm       , Ms          , Ms          , Ms          , Ms          , Ha          , Rb          , Rb          , Rb          , Rb          , Ms          , Ms          , Ms          , Ms          , Ms          , Ms          , Ms          , Ms          , Ha          , Ha          , Ha          , Ha          , Ha^Fpa      , Ha^Fpa      , Aa^Fpa      , Aa^Fpa      
Ms^Xm       , Aa^Fpa      , Aa^Fpa      , Aa^Fpa      , Aa^Fpa      , Rb          , Rb          , Rb          , Rb          , Rb          , Ha          , Ha          , Ha          , Ha^Fpa      , Ms          , Ms^Xm       , Ms          , Ms          , Ms          , Ms          , Rb          , Rb          , Rb          , Rb          , Rb          , Rb          , Ms          , Ms          , Ms          , Ms          , Ms          , Ms          , Ha          , Ha          , Ha          , Ha          , Ha          , Ha          , Ha^Fpa      , Ha^Fpa      , Aa^Fpa      , Aa^Fpa      
Ms^Xm       , Aa^Fpa      , Aa^Fpa      , Aa^Fpa      , Aa^Fpa      , Aa^Fpa      , Aa^Fpa      , Rb          , Rb          , Rb          , Rb          , Ha          , Ha          , Ms          , Ms          , Ms          , Ms          , Ms          , Rb          , Rb          , Rb          , Rb          , Rb          , Rb          , Aa^Fpa      , Aa^Fpa      , Ha^Fpa      , Ms          , Ha          , Ha          , Ms          , Ha          , Ha          , Ha          , Ha          , Ha          , Ha          , Ha^Fpa      , Ha^Fpa      , Aa^Fpa      , Aa^Fpa      , Aa^Fpa      
Ms^Xm       , Aa^Fpa      , Aa^Fpa      , Aa^Fpa      , Aa^Fpa      , Aa^Fpa      , Aa^Fpa      , Ha          , Rb          , Rb          , Rb          , Rb          , Rb          , Ms          , Ms^Vhha     , Ms          , Rb          , Rb          , Rb          , Rb          , Rb          , Rb          , Aa          , Aa^Fpa      , Ha^Fpa      , Aa^Fpa      , Ha^Fpa      , Ha          , Ha          , Ha          , Ha          , Ha          , Ha^Fpa      , Ha^Fpa      , Ha^Fpa      , Ha^Fpa      , Ha^Fpa      , Ha^Fpa      , Aa^Fpa      , Aa^Fpa      , Aa^Fpa      , Aa^Fpa      
Ms^Xm       , Ha          , Ha          , Aa^Fpa      , Aa^Fpa      , Aa^Fpa      , Aa^Fpa      , Aa^Fpa      , Ha          , Rb          , Rb          , Rb          , Rb          , Rb          , Rb          , Rb          , Rb          , Rb          , Rb          , Rb          , Aa          , Aa          , Ha          , Ha          , Ha^Fpa      , Ha^Fpa      , Ha          , Ha          , Ha          , Ha          , Ha          , Ha          , Ha^Fpa      , Ha^Fpa      , Ha^Fpa      , Ha^Fpa      , Ha^Fpa      , Ha^Fpa      , Aa^Fpa      , Aa^Fpa      , Aa^Fpa      , Ha          
Ms^Xm       , Ha          , Ha          , Ha          , Ha          , Aa^Fpa      , Aa^Fpa      , Aa^Fpa      , Ha          , Ha          , Ha          , Rb          , Rb          , Rb          , Rb          , Rb          , Rb          , Rb          , Cay         , Re^Vct      , Ha          , Ha          , Ha          , Ha^Fpa      , Ha^Fpa      , Ha          , Ha          , Ha          , Ms^Xm       , Ms^Xm       , Ms^Xm       , Ms^Xm       , Ms^Xm       , Ms^Xm       , Ha^Fpa      , Ha^Fpa      , Ms^Xm       , Aa^Fpa      , Aa^Fpa      , Aa^Fpa      , Ha          , Ha          
Ms^Xm       , Aa^Fpa      , Aa^Fpa      , Ha          , Ha          , Ha          , Ha          , Ha          , Ha          , Ha          , Ha          , Ha          , Ha          , Rb          , Rb          , Rb          , Rb          , Cay         , 5 Kay       , Cay         , Ha          , Ha          , Ha          , Ha^Fpa      , Ha          , Ha          , Ha          , Ms^Xm       , Ms^Xm       , Ms^Xm       , Ms^Xm       , Ms^Xm       , Ms^Xm       , Ms^Xm       , Ms^Xm       , Ms^Xm       , Ms^Xm       , Ms^Xm       , Ha          , Ha          , Ha          , Ha          
Ms^Xm       , Aa^Fpa      , Aa^Fpa      , Ha          , Ha          , Ha          , Ha          , Ha          , Ha          , Ha          , Ha          , Ha          , Aa^Fpa      , Aa          , Rb          , Rb          , Rb          , Cay         , Cay         , Cay         , Ha          , Ha          , Ha          , Ha          , Ha          , Ha          , Ms^Xm       , Ms^Xm       , Ms^Xm       , Ms^Xm       , Ms^Xm       , Ms^Xm       , Ms^Xm       , Ms^Xm       , Ms^Xm       , Ms^Xm       , Ms^Xm       , Ms^Xm       , Ha          , Ha          , Ha          , Ha          
Ms^Xm       , Ms^Xm       , Ha          , Ha          , Ha          , Ha          , Ha          , Ha          , Ha          , Ha          , Ha^Fpa      , Aa^Fpa      , Aa^Fpa      , Aa^Fpa      , Aa          , Rb          , Rb          , Rb          , Rb          , Rb          , Ha          , Ha          , Ha          , Ha          , Ha          , Ha          , Ms^Xm       , Ms^Xm       , Ms^Xm       , Ms^Xm       , Ms^Xm       , Ms^Xm       , Ha^Fpa      , Ms^Xm       , Ms          , Ms          , Ms          , Ms          , Ha          , Ha          , Aa^Fpa      , Aa^Fpa      
Ms^Xm       , Ms^Xm       , Ms^Xm       , Ha          , Ha^Fpa      , Ha^Fpa      , Ha^Fpa      , Ha          , Ha          , Ha          , Ha^Fpa      , Ha^Fpa      , Ha^Fpa      , Aa^Fpa      , Ha          , Rb          , Rb          , Rb          , Rb          , Rb          , Rb          , Ha          , Ha          , Ha          , Ha          , Ha          , Ha          , Ha          , Ha          , Ha          , Ha          , Ms          , Ha^Fpa      , Ms          , Ha          , Ha          , Ha          , Ms          , Ha          , Ha          , Aa^Fpa      , Aa^Fpa      
Ha^Fpa      , Ms^Xm       , Ms^Xm       , Ms^Xm       , Ha^Fpa      , Ha^Fpa      , Ha^Fpa      , Ha^Fpa      , Ha          , Ha          , Ha          , Ha          , Ha          , Ha          , Ha          , Ha          , Ha          , Aa          , Cay         , Rb          , Rb          , Ha          , Ha          , Ha          , Ha          , Ha          , Ha          , Ha          , Ha          , Ha          , Ha          , Ha^Fpa      , Ha^Fpa      , Ha^Fpa      , Ha          , Ha          , Ha          , Ms          , Ha          , Aa^Fpa      , Aa^Fpa      , Aa^Fpa      
Ha^Fpa      , Ms^Xm       , Ha          , Ms^Xm       , Ms^Xm       , Ha^Fpa      , Ha^Fpa      , Ha^Fpa      , Ha^Fpa      , Ha          , Ha          , Ha          , Ha          , Ha          , Ha          , Ha          , Ha          , Ha          , Rb          , Rb          , Rb          , Rb          , Rb          , Ha          , Ha          , Ha          , Ha          , Ha          , Ha          , Ha          , Aa^Fpa      , Aa^Fpa      , Aa^Fpa      , Aa^Fpa      , Aa^Fpa      , Ha          , Ha          , Ha          , Ha          , Aa^Fpa      , Aa^Fpa      , Aa^Fpa      
Ha^Fpa      , Ha^Fpa      , Ha          , Ms          , Ms          , Ms^Xm       , Ms^Xm       , Ha^Fpa      , Ms          , Ha^Fpa      , Ha          , Ha          , Ha          , Ha          , Ha          , Ha          , Ha          , Ha          , Rb          , Rb          , Rb          , Rb          , Rb          , Ha          , Ha          , Ha          , Ha          , Ha          , Aa^Fpa      , Aa^Fpa      , Aa^Fpa      , Aa^Fpa      , Aa^Fpa      , Aa^Fpa      , Aa^Fpa      , Ha          , Ha          , Ha          , Ha          , Aa^Fpa      , Aa^Fpa      , Aa^Fpa      
Aa^Fpa      , Ha^Fpa      , Ha^Fpa      , Ha          , Ha          , Ms          , Ms^Xm       , Ms^Xm       , Ms^Xm       , Ms          , Ms          , Ha          , Ha          , Ha          , Ha          , Ha          , Ha          , Ha          , Aa^Fpa      , Rb          , Rb          , Rb          , Rb          , Rb          , Rb          , Ha          , Aa^Fpa      , Aa^Fpa      , Aa^Fpa      , Aa^Fpa      , Aa^Fpa      , Aa^Fpa      , Aa^Fpa      , Aa^Fpa      , Ha          , Ha          , Ha          , Ha          , Ha          , Ha          , Aa^Fpa      , Aa^Fpa      
Aa^Fpa      , Aa^Fpa      , Aa^Fpa      , Ha          , Ha          , Ms          , Ms          , Ms^Xm       , Ms          , Ms^Xm       , Ms          , Ha          , Ha          , Ha          , Ha          , Ha          , Aa^Fpa      , Aa^Fpa      , Aa^Fpa      , Aa^Fpa      , Aa^Fpa      , Rb          , Rb          , Rb          , Rb          , Rb          , Aa^Fpa      , Aa^Fpa      , Aa^Fpa      , Aa^Fpa      , Aa^Fpa      , Aa^Fpa      , Ha          , Ha          , Ha          , Ha          , Ha          , Ha          , Aa^Fpa      , Aa^Fpa      , Aa^Fpa      , Aa^Fpa      
Aa^Fpa      , Aa^Fpa      , Aa^Fpa      , Ha          , Ha          , Ha          , Ha          , Ms          , Ms          , Ms          , Ha          , Ha          , Ha          , Ha          , Ha          , Ha          , Aa^Fpa      , Aa^Fpa      , Aa^Fpa      , Aa^Fpa      , Aa^Fpa      , Aa^Fpa      , Rb          , Rb          , Rb          , Rb          , Rb          , Aa^Fpa      , Ha          , Aa^Fpa      , Ha          , Ha          , Ha          , Ha          , Ha          , Ha          , Ha          , Ha          , Aa^Fpa      , Aa^Fpa      , Aa^Fpa      , Aa^Fpa      
Aa^Fpa      , Aa^Fpa      , Aa^Fpa      , Aa^Fpa      , Aa^Fpa      , Ha          , Ha          , Ha          , Ha          , Ha          , Ha          , Ha          , Ha          , Ha          , Ha          , Ha          , Aa^Fpa      , Aa^Fpa      , Aa^Fpa      , Aa^Fpa      , Ha^Fpa      , Ha^Fpa      , Ha          , Rb          , Rb          , Rb          , Rb          , Rb          , Rb          , Ha          , Rb          , Ha          , Ha          , Ha          , Ha          , Ha          , Ha          , Aa^Fpa      , Aa^Fpa      , Aa^Fpa      , Aa^Fpa      , Aa^Fpa      
Aa          , Aa^Fpa      , Aa^Fpa      , Aa^Fpa      , Aa^Fpa      , Aa^Fpa      , Aa          , Ha          , Aa          , Ha          , Aa          , Ha          , Aa          , Ha          , Aa^Fpa      , Aa^Fpa      , Aa^Fpa      , Aa^Fpa      , Aa^Fpa      , Aa^Fpa      , Ha^Fpa      , Ha          , Ha          , Ha          , Ha          , Rb          , Rb          , Rb          , Rb          , Rb          , Rb          , Rb          , Rb          , Rb          , Ce          , Aa          , Aa          , Aa^Fpa      , Aa^Fpa      , Aa^Fpa      , Aa^Fpa      , Aa          
Aa          , Aa^Fpa      , Aa^Fpa      , Aa^Fpa      , Aa^Fpa      , Aa^Fpa      , Aa          , Aa          , Aa          , Aa          , Aa          , Aa          , Aa          , Aa          , Aa^Fpa      , Aa^Fpa      , Aa^Fpa      , Aa^Fpa      , Aa^Fpa      , Aa^Fpa      , Aa^Fpa      , Ha^Fpa      , Aa          , Ha          , Aa          , Aa          , Rb          , Rb          , Rb          , Rb          , Rb          , Rb          , Rb          , Rb          , Ce          , Ce          , Aa          , Aa^Fpa      , Aa^Fpa      , Aa^Fpa      , Aa          , Aa          
Aa          , Aa          , Aa          , Aa^Fpa      , Aa^Fpa      , Aa^Fpa      , Aa          , Aa          , Aa          , 3 Aa        , Aa          , Aa          , Aa          , Aa          , Aa^Fpa      , Aa^Fpa      , Aa^Fpa      , Aa^Fpa      , Aa^Fpa      , Aa^Fpa      , Aa^Fpa      , Aa^Fpa      , Aa^Fpa      , Aa          , Aa          , Aa          , Aa          , Rb          , Rb          , Rb          , Re^Vct      , Rb          , Ce          , Ce          , 1 Ke        , Ce          , Rb          , Aa          , Aa          , Aa          , Aa          , Aa          
Aa          , Aa          , Aa          , Aa          , Aa          , Aa          , Aa          , Aa          , Aa          , Aa          , Aa          , Aa          , Aa          , Aa          , Aa^Fpa      , Aa^Fpa      , Aa^Fpa      , Aa^Fpa      , Aa^Fpa      , Aa^Fpa      , Aa^Fpa      , Aa^Fpa      , Aa^Fpa      , Aa^Fpa      , Aa          , Aa          , Aa          , Aa          , Aa          , Aa          , Aa          , Aa          , Aa          , Rb          , Rb          , Rb          , Rb          , Aa          , Aa          , Aa          , Aa          , Aa          
