border_size=1
usage=map

Uu          , Xu          , Xu          , Uu          , Ur          , Uu          , Urb         , Urb         , Urb         , Urb         , Urb         , Rb^Uf       , Rb^Uf       , Rb^Uf       , Xu          , Xu          , Xu          , Uu          , Uu^Vu       , Uu          , Uu          , Xu          
Xu          , Xu          , Xu          , Uu          , Xu          , Ur          , Ur          , Rb          , Rb          , Rb          , Urb         , Rb^Uf       , Rb^Uf       , Rb^Uf       , Xu          , Xu          , Xu          , Xu          , 1 Uu        , Xu          , Xu          , Xu          
Xu          , Xu          , Uh          , Uu          , Uu          , Ur          , Xu          , Rb          , Uu          , Uu          , Rb          , 2 Rb        , Rb^Uf       , Uu          , Uu          , Xu          , Xu          , Xu          , Xu          , Xu          , Xu          , Xu          
Xu          , Xu          , Uu          , Ur          , Ur          , Uu          , Xu          , Uu          , Xu          , Uu^Uf       , Uu          , Ur          , Rb          , Rb          , Uu          , Uu          , Uh          , Xu          , Uh          , Uu          , Xu          , Xu          
Xu          , Uh          , Uu          , Ur          , Uu          , Xu          , Xu          , Xu          , Xu          , Xu          , Uu          , Uu          , Ur          , Rb          , Urb         , Uu          , Uu          , Uu          , Uu          , Uu          , Uu          , Xu          
Xu          , Uu          , Uu          , Ur          , Uu          , Xu          , Xu          , Xu          , Qxu         , Xu          , Uu          , Uu          , Ur          , Urb         , Urb         , Xu          , Xu          , Xu          , Uu          , Ur          , Uu          , Uu          
Uh          , Rb          , Rb          , Uu          , Xu          , Xu          , Xu          , Xu          , Uu          , Ur          , Uu          , Uu          , Uu          , Urb         , Urb         , Urb         , Uu          , Uu          , Xu          , Uu          , Ur          , Ur          
Rb          , Uu          , Uu          , Xu          , Xu          , Xu          , Xu          , Xu          , Ur          , Uu          , Xu          , Xu          , Uu          , Rb          , Rb          , Uu          , Uu          , Uu          , Uu          , Xu          , Uu          , Uu          
Uu          , Uu          , Uu          , Xu          , Xu          , Xu          , Xu          , Xu          , Ur          , Ur          , Uu          , Xu          , Uu          , Rb          , Uu          , Uu          , Xu          , Xu          , Xu          , Xu          , Xu          , Xu          
Uu          , Xu          , Xu          , Xu          , Xu          , Xu          , Xu          , Xu          , Xu          , Ur          , Ur          , Cpy         , Urb         , Rb          , Uu          , Uu          , Xu          , Xu          , Xu          , Xu          , Xu          , Xu          
Rb          , Rb          , Uh          , Uh          , Uu          , Uu          , Uu          , Uu          , Uu          , Urb         , Urb         , Mybd        , Urb         , Urb         , Uu          , Uu^Uf       , Uu          , Xu          , Xu          , Xu          , Xu          , Uu          
Xu          , Xu          , Uu          , Uu          , Xu          , Urb         , Uu          , Urb         , Urb         , Mybd        , Mybd        , Mybd        , Mybd        , Mybd        , Urb         , Uu          , Uu          , Uu          , Uh          , Xu          , Uu          , Ur          
Xu          , Xu          , Uu          , Xu          , Xu          , Urb         , Uu          , Cpy         , Mybd        , Mybd        , Mybd        , Mybd        , Mybd        , Mybd        , Mybd        , Cpy         , Uu          , Xu          , Uu          , Uu^Uf       , Ur          , Uu          
Xu          , Xu          , Ur          , Ur          , Rb          , Urb         , Xu          , Urb         , Mybd        , Mybd        , Mybd        , Mybd        , Mybd        , Mybd        , Mybd        , Urb         , Uu          , Xu          , Rb          , Uu          , Xu          , Xu          
Xu          , Rb          , Ur          , Uu          , Rb          , Urb         , Xu          , Uu          , Urb         , Urb         , Mybd        , Mybd        , Mybd        , Urb         , Urb         , Urb         , Uu          , Uu          , Urb         , Uu          , Xu          , Xu          
Rb          , Xu          , Ur          , Xu          , Xu          , Urb         , Rb^Uf       , Xu          , Xu          , Uu          , Urb         , Uu          , Urb         , Uu          , Xu          , Urb         , Xu          , Uu          , Urb         , Uu          , Xu          , Xu          
Xu          , Xu          , Ur          , Xu          , Xu          , Urb         , Uu          , Xu          , Uu^Vu       , Xu          , Xu          , Uh          , Urb         , Uu          , Xu          , Xu          , Xu          , Rb          , Urb         , Uu          , Xu          , Xu          
Uu          , Xu          , Uu          , Uu          , Urb         , Urb         , Xu          , Xu          , Uu          , Xu          , Uu          , Uh          , Urb         , Xu          , Uu^Vu       , Xu          , Xu          , Urb         , Uh          , Uh          , Xu          , Xu          
Uu          , Xu          , Rb^Uf       , Uu          , Urb         , Urb         , Xu          , Xu          , Uu          , Uu          , Uu          , Urb         , Xu          , Uu          , Uu          , Xu          , Xu          , Ur          , Uh          , Uu          , Xu          , Ur          
Xu          , Xu          , Uu          , Uu          , Urb         , Xu          , Uh          , Uh          , Xu          , Urb         , Xu          , Xu          , Xu          , Xu          , Rb          , Xu          , Xu          , Ur          , Ur          , Uu          , Ur          , Ur          
Xu          , Xu          , Uu          , Uu          , Urb         , Xu          , Uh          , Uh          , Xu          , Urb         , Xu          , Xu          , Urb         , Urb         , Xu          , Xu          , Xu          , Uu          , Ur          , Ur          , Ur          , Uu          
Xu          , Xu          , Ur          , Uu          , Uu          , Rb          , Xu          , Xu          , Uu          , Urb         , Xu          , Rb          , Uu          , Xu          , Xu          , Xu          , Uu          , Ur          , Ur          , Uu          , Uu          , Uu          
