border_size=1
usage=map

Xv          , Xv          , Xv          , Xv          , Xv          , Xv          , Xv          , Xv          , Xv          , Xv          , Xv          , Xv          , Xv          , Xv          , Xv          , Xv          , Xv          , Xv          , Xv          , Xv          , Xv          , Xv          , Xv          , Xv          , Xv          , Xv          , Xv          , Xv          , Xv          , Xv          , Xv          , Xv          , Xv          , Xv          , Xv          , Xv          , Xv          , Xv          , Xv          , Xv          , Xv          , Xv          , Xv          , Xv          , Xv          , Xv          
Xv          , Xv          , Xv          , Ysls        , Xv          , Yslg        , Xv          , Ysld        , Xv          , Xv          , Xv          , Xv          , Xv          , Xv          , Xv          , Xv          , Xv          , Xv          , Xv          , Xv          , Xv          , Xv          , Xv          , Xv          , Xv          , Xv          , Xv          , Xv          , Xv          , Xv          , Xv          , Xv          , Xv          , Xv          , Xv          , Xv          , Xv          , Xv          , Xv          , Xv          , Xv          , Xv          , Xv          , Xv          , Xv          , Xv          
Xv          , Xv          , Xv          , Xv          , Xv          , Xv          , Xv          , Xv          , Xv          , Xv          , Xv          , Xv          , Xv          , Xv          , Xv          , Xv          , Xv          , Xv          , Xv          , Xv          , Xv          , Xv          , Xv          , Xv          , Xv          , Xv          , Xv          , Xv          , Xv          , Xv          , Xv          , Xv          , Xv          , Xv          , Xv          , Xv          , Xv          , Xv          , Xv          , Xv          , Xv          , Xv          , Xv          , Xv          , Xv          , Xv          
Xv          , Xv          , Xv          , Xv          , Xv          , Xv          , Xv          , Xv          , Xv          , Xv          , Xv          , Xv          , Xv          , Xv          , Xv          , Xv          , Xv          , Xv          , Xv          , Xv          , Xv          , Xv          , Xv          , Xv          , Uu^Xo       , Xv          , Xv          , Xv          , Xv          , Xv          , Xv          , Xv          , Xv          , Xv          , Xv          , Xv          , Xv          , Xv          , Xv          , Xv          , Xv          , Xv          , Xv          , Xv          , Xv          , Xv          
Xv          , Xv          , Xv          , Xv          , Xv          , Xv          , Xv          , Xv          , Xv          , Xv          , Xv          , Xv          , Xv          , Xv          , Xv          , Xv          , Xv          , Xv          , Xv          , Xv          , Xv          , Xv          , Xv          , Ur^Xo       , Ur          , Uu^Xo       , Urb^Xo      , Xv          , Xv          , Xv          , Xv          , Xv          , Xv          , Xv          , Xv          , Xv          , Xv          , Xv          , Xv          , Xv          , Xv          , Xv          , Xv          , Xv          , Xv          , Xv          
Xv          , Xv          , Xv          , Xv          , Xv          , Xv          , Xv          , Xv          , Xv          , Xv          , Xv          , Xv          , Xv          , Xv          , Xv          , Xv          , Xv          , Xv          , Xv          , Xv          , Xv          , Xv          , Xv          , Uu^Xo       , Ur^Xo       , Ur          , Uu^Xo       , Xv          , Xv          , Xv          , Xv          , Xv          , Xv          , Xv          , Xv          , Xv          , Xv          , Xv          , Xv          , Xv          , Xv          , Xv          , Xv          , Xv          , Xv          , Xv          
Xv          , Xv          , Xv          , Xv          , Xv          , Xv          , Xv          , Xv          , Xv          , Xv          , Xv          , Xv          , Xv          , Xv          , Xv          , Xv          , Xv          , Xv          , Xv          , Xv          , Xv          , Xv          , Xv          , Uu^Xo       , Ur^Xo       , Ur^Xo       , Rr^Xo       , Xv          , Xv          , Xv          , Xv          , Xv          , Xv          , Xv          , Xv          , Xv          , Xv          , Xv          , Xv          , Xv          , Xv          , Xv          , Xv          , Xv          , Xv          , Xv          
Xv          , Xv          , Xv          , Xv          , Xv          , Xv          , Xv          , Xv          , Xv          , Xv          , Xv          , Xv          , Ms          , Xv          , Ms          , Ms          , Rrc         , Xv          , Rrc         , Xv          , Rrc         , Xv          , Rrc         , Rrc^Xo      , 4 Rrc       , Rrc^Xo      , Rrc         , Rrc         , Cay         , Rrc         , Rrc         , Ms          , Ms          , Ms          , Ms          , Xv          , Xv          , Xv          , Xv          , Xv          , Xv          , Xv          , Xv          , Xv          , Xv          , Xv          
Xv          , Xv          , Xv          , Xv          , Xv          , Xv          , Xv          , Xv          , Ms          , Xv          , Ms          , Ms          , Rrc         , Ms          , Rrc         , Rrc         , Rrc         , Rrc         , Rrc         , Cay         , Kay         , Rrc         , Rrc         , Rrc         , Rrc         , Rrc         , Rrc         , Rrc         , Kay         , Cay         , Rrc         , Rrc         , Rrc         , Rrc         , Rrc         , Ms          , Ms          , Xv          , Xv          , Xv          , Xv          , Xv          , Xv          , Xv          , Xv          , Xv          
Xv          , Xv          , Xv          , Xv          , Ms          , Xv          , Ms          , Ms          , Ms          , Ms          , Ms          , Rrc         , Ms          , Rrc         , Rrc         , Rrc         , Rrc         , Rrc         , Rrc         , Cay         , Cay         , Rrc         , Rrc         , Rrc         , Rrc         , Rrc         , Rrc         , Rrc         , Cay         , Cay         , Rrc         , Rrc         , Ms          , Rrc         , Ms          , Ms          , Ms          , Ms          , Ms          , Xv          , Xv          , Xv          , Xv          , Xv          , Xv          , Xv          
Ms          , Ms          , Ms          , Ms          , Ms          , Ms          , Ms          , Ms          , Ms          , Aa          , Aa          , Ms          , Aa          , Ms          , Ms          , Rrc         , Rrc         , Rrc         , Rrc         , Rrc         , Rrc         , Cay         , Cay         , Rrc         , Rrc         , Rrc         , Rrc         , Cay         , Rrc         , Rrc         , Ms          , Ms          , Ms          , Ms          , Ms          , Ms          , Ms          , Ms          , Ms          , Ms          , Ms          , Xv          , Xv          , Xv          , Xv          , Xv          
Ms          , Ms          , Ms          , Ms          , Aa          , Aa          , Aa          , Ms          , Ms          , Aa          , Aa          , Aa          , Aa          , Aa          , Ms          , Ms          , Ms          , Ms          , Ms          , Rrc         , Ms          , Rrc         , Rrc         , Rrc         , Rrc         , Rrc         , Rrc         , Rrc         , Ms          , Rrc         , Ms          , Ms          , Ha^Fpa      , Ha          , Ha^Fpa      , Ha          , Ha          , Ms          , Ms          , Ms          , Ms          , Ms          , Ms          , Ms          , Ms          , Xv          
Ms          , Ms          , Aa          , Aa          , Aa          , Aa^Voa      , Aa          , Aa          , Ms          , Ms          , Aa          , Aa          , Aa          , Aa          , Aa          , Ms          , Aa          , Ms          , Ha          , Ms          , Rr          , Rrc         , Ms          , Ms          , Ms          , Rrc         , Rr          , Ms          , Rr          , Ms          , Aa          , Aa          , Aa          , Aa          , Aa          , Aa          , Aa          , Ha          , Ha          , Ha          , Ha          , Ms          , Ms          , Ms          , Ms          , Ms          
Ms          , Aa          , Aa          , Aa          , Aa          , Aa          , Rb          , Aa          , Aa          , Ms          , Ms          , Aa          , Aa          , Aa          , Aa          , Aa          , Aa          , Aa^Voa      , Rb          , Rr          , Ms          , Ms          , Ms          , Ms          , Ms          , Ms          , Ms          , Rr          , Rb          , Rb          , Rb          , Aa          , Aa          , Aa          , Aa          , Aa          , Aa          , Aa          , Aa          , Aa          , Aa          , Ha          , Ha          , Ms          , Ms          , Ms          
Ms          , Aa          , Aa          , Aa          , Aa          , Aa          , Ms          , Rb          , Rb          , Aa          , Aa          , Aa          , Rb          , Aa          , Aa          , Ha          , Rb          , Rb          , Aa          , Ms          , Ms          , Ms          , Ms          , Ms          , Ms          , Ms          , Ms          , Ha          , Rb          , Aa          , Aa          , Rb          , Rb          , Aa          , Ms          , Ms          , Ms          , Aa          , Aa          , Aa          , Aa          , Aa          , Aa          , Ms          , Ms          , Ms          
Ms          , Ms          , Ms          , Ms          , Ms          , Ms          , Ms          , Aa          , Aa          , Rb          , Rb          , Rb          , Ms          , Rb          , Rb          , Aa          , Rb          , Aa          , Aa          , Ms          , Ms          , Ms          , Ms          , Ms          , Ms          , Ms          , Ha          , Ha          , Rb          , Ms          , Ms          , Aa          , Rb          , Aa          , Aa          , Ms          , Ms          , Ms          , Ha^Fpa      , Aa^Fpa      , Aa^Fpa      , Aa          , Aa^Fpa      , Ha^Fpa      , Ms          , Ms          
Ms          , Ms          , Ms          , Ms          , Ms          , Ha^Fpa      , Aa^Fpa      , Aa          , Aa          , Aa          , Aa          , Ms          , Ms          , Ms          , Ha          , Rb          , Rb          , Aa          , Aa          , Ha          , Ha          , Ms          , Ms          , Ms          , Ha^Fpa      , Ha          , Rb          , Rb          , Ms          , Ms          , Ms          , Ha          , Ha          , Rb          , Rb          , Aa          , Aa          , Ha          , Aa^Fpa      , Aa^Fpa      , Aa^Fpa      , Aa^Fpa      , Aa^Fpa      , Ha^Fpa      , Ha          , Ms          
Ms          , Ms          , Ms          , Ms          , Aa          , Ha^Fpa      , Aa^Fpa      , Aa          , Tyb         , Aa          , Aa          , Ha          , Ha          , Ms          , Ha          , Aa          , Aa          , Rb          , Aa          , Aa          , Rb          , Aa          , Ha          , Ha          , Ha          , Ha          , Rb          , Ms          , Ms          , Ms          , Ms          , Ms          , Ms          , Ha          , Ha          , Rb          , Rb          , Aa          , Rb          , Aa^Fpa      , Aa          , Aa^Fpa      , Aa          , Aa^Fpa      , Aa          , Ha          
Ms          , Ms          , Ha          , Aa          , Aa          , Aa^Fpa      , Aa          , Tyb         , Tyb         , Aa          , Aa          , Aa          , Aa          , Ha          , Aa          , Aa          , Aa          , Rb          , Rb          , Rb          , Aa          , Rb          , Rb          , Rb          , Rb          , Ha          , Rb          , Ha          , Aa          , Aa          , Ha          , Ms          , Ms          , Ms          , Ha          , Aa          , Rb          , Rb          , Rb          , Rb          , Rb          , Aa          , Rb          , Aa          , Aa          , Aa          
Ms          , Ms          , Ha          , Ha          , Aa          , Aa          , Aa          , Aa          , Aa          , Aa          , Ms          , Ms          , Ms          , Aa          , Aa          , Ms          , Ha          , Aa          , Rb          , Kay         , Cay         , Aa          , Aa          , Ms          , Ms          , Rb          , Ms          , Rb          , Rb          , Aa          , Aa          , Ha          , Ha          , Ms          , Ha          , Aa          , Rb          , Aa          , Ha          , Aa          , Aa          , Rb          , Aa          , Rb          , Rb          , Rb          
Ms          , Ms          , Ha          , Aa          , Aa          , Aa          , Ms          , Ms          , Ms          , Ms          , Ms          , Ms          , Ms          , Ha          , Ms          , Ms          , Ha          , Aa          , Rb          , Cay         , Aa          , Aa          , Ms          , Ms          , Ms          , Ms          , Ms          , Ha          , Aa          , Rb          , Aa          , Aa          , Aa          , Ha          , Ha^Fpa      , Aa          , Rb          , Ha          , Ms          , Aa          , Aa          , Aa          , Aa          , Aa          , Aa          , Aa          
Ms          , Ms          , Ha          , Ha          , Aa          , Ms          , Ms          , Ms          , Ms          , Ms          , Ms          , Ms          , Ms          , Ms          , Ha          , Ha          , Aa          , Aa          , Rb          , Aa          , Aa          , Aa          , Aa          , Ms          , Ha^Fpa      , Ms          , Ms          , Aa          , Aa          , Rb          , Rb          , Aa^Fpa      , Aa^Fpa      , Aa^Fpa      , Aa^Fpa      , Aa          , Rb          , Ha          , Ms          , Ms          , Ms          , Aa          , Aa          , Aa^Voa      , Aa          , Aa          
Ms          , Ms          , Ha          , Aa          , Aa          , Aa          , Aa          , Aa          , Ms          , Ms          , Ms          , Ms          , Ms          , Ms          , Aa^Voa      , Aa          , Aa          , Aa          , Rb          , Aa          , Aa          , Aa          , Aa          , Ha^Fpa      , Ha^Fpa      , Ms          , Ms          , Aa          , Aa          , Rb          , Rb          , Aa^Fpa      , Aa^Fpa      , Aa^Fpa      , Aa^Fpa      , Aa          , Rb          , Ha          , Ha          , Ms          , Ms          , Ms          , Ms          , Aa          , Aa          , Aa          
Ms          , Ms          , Ha          , Aa          , Aa          , Aa          , Aa^Voa      , Aa          , Aa          , Aa          , Ms          , Ms          , Ha          , Ha          , Aa          , Aa          , Aa          , Rb          , Aa          , Aa          , Aa          , Aa          , Aa          , Aa^Fpa      , Aa          , Ha          , Aa          , Aa          , Aa          , Aa          , Rb          , Rb          , Rb          , Rb          , Rb          , Aa          , Rb          , Aa          , Aa          , Ha          , Ha          , Ms          , Ms          , Ms          , Ms          , Aa          
Ms          , Ms          , Ms          , Aa          , Aa          , Aa          , Aa          , Aa          , Ms          , Ms          , Ha          , Ha          , Ha^Fpa      , Ha          , Aa          , Aa          , Aa          , Rb          , Aa          , Aa          , Rb          , Aa          , Aa          , Aa          , Rb          , Rb          , Rb          , Aa          , Rb          , Rb          , Aa          , Aa          , Aa          , Aa          , Aa          , Rb          , Aa          , Aa^Fpa      , Aa          , Aa          , Ha^Fpa      , Ha          , Ha          , Ms          , Ms          , Aa          
Ms          , Ms          , Aa          , Aa          , Aa          , Aa          , Ms          , Ms          , Ha          , Ha          , Ha          , Ha          , Ha^Fpa      , Ha^Fpa      , Aa^Fpa      , Aa          , Rb          , Rb          , Rb          , Rb          , Aa          , Rb          , Rb          , Rb          , Aa          , Aa          , Aa          , Rb          , Aa          , Aa          , Aa          , Aa          , Aa          , Aa          , Rb          , Rb          , Aa          , Aa          , Aa^Fpa      , Aa^Fpa      , Aa^Fpa      , Ha^Fpa      , Ha          , Ms          , Ms          , Ms          
Ms          , Ms          , Aa          , Aa          , Aa          , Aa          , Aa          , Aa          , Aa          , Aa          , Aa          , Aa          , Aa^Fpa      , Aa^Fpa      , Aa^Fpa      , Aa          , Rb          , Rb          , Aa          , Aa          , Aa^Fpa      , Aa          , Aa          , Aa          , Tyb         , Aa          , Aa          , Aa          , Aa          , Aa^Voa      , Aa          , Aa          , Aa          , Aa          , Rb          , Aa          , Aa          , Aa          , Aa          , Aa          , Aa          , Aa          , Ha          , Ha          , Ha          , Ms          
Ms          , Ms          , Ha          , Aa          , Aa          , Aa          , Rb          , Aa          , Aa          , Aa          , Aa          , Aa          , Aa          , Aa^Fpa      , Aa          , Rb          , Aa          , Aa          , Aa          , Aa          , Aa^Fpa      , Aa          , Aa          , Tyb         , Tyb         , Tyb         , Tyb         , Aa          , Aa          , Aa          , Aa          , Rb          , Rb          , Rb          , Rb          , Aa          , Rb          , Aa          , Aa          , Aa          , Aa          , Aa          , Aa          , Ha          , Ha          , Ha          
Ms          , Ms          , Ha          , Ha          , Ms          , Aa          , Aa          , Rb          , Aa          , Aa          , Aa          , Aa          , Aa          , Aa          , Aa          , Rb          , Aa          , Aa          , Aa          , Aa          , Aa          , Aa^Fpa      , Aa          , Tyb         , Tyb         , Tyb         , Tyb         , Tyb         , Aa          , Aa^Fpa      , Aa          , Aa          , Aa          , Aa          , Aa          , Rb          , Aa          , Rb          , Rb          , Aa          , Aa          , Aa          , Aa^Voa      , Aa          , Aa          , Aa          
Ms          , Ha          , Ha          , Ms          , Ms          , Aa          , Aa          , Aa          , Aa^Fpa      , Aa          , Aa          , Aa          , Rb          , Aa          , Rb          , Rb          , Aa          , Aa          , Aa          , Aa          , Aa          , Aa          , Aa          , Aa          , Aa          , Tyb         , Aa          , Aa          , Aa          , Aa          , Aa          , Aa          , Ms          , Ms          , Ms          , Aa          , Aa          , Aa          , Aa          , Rb          , Rb          , Aa          , Aa          , Aa          , Aa          , Aa          
Ms          , Ha          , Ms          , Ms          , Ha          , Aa          , Ha          , Aa          , Aa          , Aa          , Rb          , Rb          , Aa          , Rb          , Aa          , Aa          , Aa          , Aa          , Aa^Voa      , Aa          , Aa          , Aa          , Aa          , Aa          , Aa          , Aa          , Aa          , Aa          , Aa          , Aa          , Aa          , Ha          , Ha          , Ms          , Ha          , Ha          , Ha          , Aa          , Aa          , Aa          , Aa          , Rb          , Aa          , Aa          , Aa          , Aa          
Ms          , Ms          , Ms          , Ha          , Ha          , Ha          , Aa          , Aa          , Rb          , Rb          , Aa          , Aa          , Aa          , Aa          , Aa          , Aa          , Aa          , Aa          , Aa          , Aa          , Aa          , Aa^Fpa      , Aa          , Aa          , Aa          , Aa          , Aa^Voa      , Aa          , Aa          , Aa          , Aa          , Aa          , Aa          , Ha          , Ha          , Ha^Fpa      , Ha^Fpa      , Aa^Fpa      , Aa^Fpa      , Aa          , Aa          , Rb          , Rb          , Aa          , Aa          , Aa          
Ms          , Ms          , Aa          , Aa          , Aa          , Aa          , 1 Ha        , Aa          , Aa          , Aa          , Aa          , Aa          , Ms          , Aa          , Ms          , Aa          , Aa          , Aa          , Ms          , Aa          , Aa          , Aa          , Aa          , Aa          , Aa          , Aa          , Aa          , Aa          , Aa          , Aa          , Aa          , Aa          , Aa          , Ha          , Aa          , Ha          , Aa          , Aa^Fpa      , Aa          , Aa          , Aa          , Aa          , Aa          , Rb          , Rb          , Aa          
Qxu         , Aa          , Qxu         , 5 Aa        , Qxu         , Aa          , Ha          , Ha          , Ha          , Aa          , Ms          , Ms          , Ms          , Ms          , Aa          , Ms          , Ms          , Ms          , Ms          , Ms          , Ms          , Aa          , Ms          , Aa          , Aa          , Aa          , Ms          , Aa          , Aa          , Aa          , Aa          , Aa          , Aa          , Aa          , Aa          , Aa          , Aa          , Aa          , Aa          , Aa          , Aa          , 2 Aa        , Aa          , 3 Aa        , Rb          , Rb          
Xv          , Qxu         , Xv          , Qxu         , Xv          , Qxu         , Aa          , Aa          , Ms          , Ms          , Aa          , Ms          , Aa          , Aa          , Aa          , Aa          , Aa          , Aa          , Aa          , Aa          , Aa          , Ms          , Aa          , Ms          , Ms          , Aa          , Ms          , Ha          , Ha          , Ha          , Ha          , Aa          , Ha          , Aa          , Aa          , Aa          , Aa          , Aa          , Aa          , Aa          , Aa          , Aa          , Aa          , Aa          , Aa          , Aa          
Xv          , Xv          , Xv          , Xv          , Xv          , Qxu         , Qxu         , Ms          , Qxu         , Aa          , Aa          , Aa          , Aa          , Aa          , Aa          , Aa          , Ha^Fpa      , Aa^Fpa      , Aa          , Aa          , Aa          , Aa          , Ms          , Ms          , Ms          , Ms          , Ms          , Ms          , Ms          , Ha          , Ha          , Ha          , Ha          , Ha          , Ha          , Aa          , Aa          , Aa          , Aa^Fpa      , Aa^Fpa      , Aa          , Aa          , Aa          , Aa^Vct      , Aa          , Aa          
Xv          , Xv          , Xv          , Xv          , Xv          , Xv          , Xv          , Qxu         , Xv          , Qxu         , Qxu         , Qxu         , Qxu         , Aa          , Qxu         , Aa          , Aa          , Ha^Fpa      , Aa          , Aa          , Ms          , Ms          , Ms^Xm       , Ms^Xm       , Ms^Xm       , Ms^Xm       , Ms^Xm       , Ms^Xm       , Ms          , Ms          , Ms          , Ms          , Ms          , Ms          , Ms          , Ha          , Ha          , Aa          , Aa          , Aa^Fpa      , Aa          , Aa          , Aa          , Aa          , Aa          , Aa          
Xv          , Xv          , Xv          , Xv          , Xv          , Xv          , Xv          , Xv          , Xv          , Xv          , Xv          , Xv          , Xv          , Qxu         , Qxu         , Aa          , Aa          , Aa          , Aa          , Aa          , Ms          , Ms^Xm       , Ms^Xm       , Ms^Xm       , Ms^Xm       , Ms^Xm       , Ms^Xm       , Ms^Xm       , Ms^Xm       , Ms          , Ms          , Ms          , Ms          , Ms          , Ms          , Ha          , Ha          , Ha          , Aa          , Aa          , Aa          , Tyb         , Tyb         , Aa          , Aa          , Aa          
Xv          , Xv          , Xv          , Xv          , Xv          , Xv          , Xv          , Xv          , Xv          , Xv          , Xv          , Xv          , Xv          , Xv          , Xv          , Qxu         , Qxu         , Aa          , Aa          , Aa          , Ms          , Ms          , Ms          , Ms^Xm       , Ms^Xm       , Ms^Xm       , Ms^Xm       , Ms^Xm       , Ms^Xm       , Ms^Xm       , Ms^Xm       , Ms          , Ms          , Ms          , Ms          , Ha          , Ha          , Ha          , Aa          , Aa          , Tyb         , Tyb         , Tyb         , Tyb         , Tyb         , Aa          
