border_size=1
usage=map

Xu          , Xu          , Xu          , Xu          , Xu          , Xu          , Xu          , Xu          , Xu          , Xu          , Xu          , Xu          , Xu          , Xu          
Xu          , Xu          , Xu          , Xu          , Xu          , Xu          , Xu          , Xu          , Xu          , Xu          , Xu          , Xu          , Xu          , Xu          
Xu          , Xu          , Xu          , Xu          , Xu          , Xu          , Xu          , Xu          , Xu          , Xu          , Xu          , Xu          , Xu          , Xu          
Xu          , Xu          , Xu          , Xu          , Xu          , Xu          , Ce          , Xu          , Xu          , Xu          , Xu          , Xu          , Xu          , Xu          
Xu          , Xu          , Xu          , Xu          , Ce          , Ce          , Ce          , Ce          , Ce          , Xu          , Xu          , Xu          , Xu          , Xu          
Xu          , Xu          , Xu          , Xu          , Rp^Xo       , Ce          , Ce          , Ce          , Ce          , Xu          , Xu          , Xu          , Xu          , Xu          
Xu          , Xu          , Xu          , Xu          , Rp          , Rp^Xo       , Rp^Xo       , Ce^Xo       , Rp^Xo       , Rp^Xo       , Xu          , Xu          , Xu          , Xu          
Xu          , Xu          , Xu          , Xu          , Rp          , Rp          , Rp          , Rp          , Rp          , Rp          , Xu          , Xu          , Xu          , Xu          
Xu          , Xu          , Xu          , Xu          , Rp          , Rp          , Ce          , Rp          , Rp          , Rp          , Xu          , Xu          , Xu          , Xu          
Xu          , Xu          , Xu          , Xu          , Rp          , Ce          , 1 Ke        , Ce          , Rp          , Rp          , Xu          , Xu          , Xu          , Xu          
Xu          , Xu          , Xu          , Xu          , Rp          , Ce          , Ce          , Ce          , Rp          , Rp          , Xu          , Xu          , Xu          , Xu          
Xu          , Xu          , Xu          , Xu          , Rp          , Rp          , Rp          , Rp          , Rp          , Xu          , Xu          , Xu          , Xu          , Xu          
Xu          , Xu          , Xu          , Xu          , Rp          , Rp          , Rp          , Rp          , Rp          , Xu          , Xu          , Xu          , Xu          , Xu          
Xu          , Xu          , Xu          , Xu          , Xu          , Rp          , Rp          , Rp          , Rp          , Xu          , Xu          , Xu          , Xu          , Xu          
